0,1,2,3,4,5,6,7,8,9,10,11,12,13,14,15,16,17,18,19,20,21,22,23,24,25,26,27,28,29,30,31,32,33,34,35,36,37,38,39,40,41,42,43,44,45,46,47,48,49,50,51,52,53,54,55,56,57,58,59,60,61,62,63,64,65,66,67,68,69,70,71,72,73,74,75,76,77,78,79,80,81,82,83,84,85,86,87,88,89,90,91,92,93,94,95,96,97,98,99,100,101,102,103,104,105,106,107,108,109
18,17,16,15,14,13,12,11,10,9,8,7,6,5,4,3,2,1,0,0,1,2,3,4,5,6,7,8,9,10,11,12,13,14,15,16,17,18,19,20,21,22,23,24,25,26,27,28,29,30,31,32,33,34,35,36,36,35,34,33,32,31,30,29,28,27,26,25,24,23,22,21,20,19,18,17,16,15,14,13,12,11,10,9,8,7,6,5,4,3,2,1,0,0,1,2,3,4,5,6,7,8,9,10,11,12,13,14,15,16
19,18,17,16,15,14,13,12,11,10,9,8,7,6,5,4,3,2,1,1,2,3,4,5,6,7,8,9,10,11,12,13,14,15,16,17,18,19,20,21,22,23,24,25,26,27,28,29,30,31,32,33,34,35,36,37,37,36,35,34,33,32,31,30,29,28,27,26,25,24,23,22,21,20,19,18,17,16,15,14,13,12,11,10,9,8,7,6,5,4,3,2,1,1,2,3,4,5,6,7,8,9,10,11,12,13,14,15,16,17
20,19,18,17,16,15,14,13,12,11,10,9,8,7,6,5,4,3,2,2,3,4,5,6,7,8,9,10,11,12,13,14,15,16,17,18,19,20,21,22,23,24,25,26,27,28,29,30,31,32,33,34,35,36,37,38,38,37,36,35,34,33,32,31,30,29,28,27,26,25,24,23,22,21,20,19,18,17,16,15,14,13,12,11,10,9,8,7,6,5,4,3,2,2,3,4,5,6,7,8,9,10,11,12,13,14,15,16,17,18
21,20,19,18,17,16,15,14,13,12,11,10,9,8,7,6,5,4,3,3,4,5,6,7,8,9,10,11,12,13,14,15,16,17,18,19,20,21,22,23,24,25,26,27,28,29,30,31,32,33,34,35,36,37,38,39,39,38,37,36,35,34,33,32,31,30,29,28,27,26,25,24,23,22,21,20,19,18,17,16,15,14,13,12,11,10,9,8,7,6,5,4,3,3,4,5,6,7,8,9,10,11,12,13,14,15,16,17,18,19
22,21,20,19,18,17,16,15,14,13,12,11,10,9,8,7,6,5,4,4,5,6,7,8,9,10,11,12,13,14,15,16,17,18,19,20,21,22,23,24,25,26,27,28,29,30,31,32,33,34,35,36,37,38,39,40,40,39,38,37,36,35,34,33,32,31,30,29,28,27,26,25,24,23,22,21,20,19,18,17,16,15,14,13,12,11,10,9,8,7,6,5,4,4,5,6,7,8,9,10,11,12,13,14,15,16,17,18,19,20
23,22,21,20,19,18,17,16,15,14,13,12,11,10,9,8,7,6,5,5,6,7,8,9,10,11,12,13,14,15,16,17,18,19,20,21,22,23,24,25,26,27,28,29,30,31,32,33,34,35,36,37,38,39,40,41,41,40,39,38,37,36,35,34,33,32,31,30,29,28,27,26,25,24,23,22,21,20,19,18,17,16,15,14,13,12,11,10,9,8,7,6,5,5,6,7,8,9,10,11,12,13,14,15,16,17,18,19,20,21
24,23,22,21,20,19,18,17,16,15,14,13,12,11,10,9,8,7,6,6,7,8,9,10,11,12,13,14,15,16,17,18,19,20,21,22,23,24,25,26,27,28,29,30,31,32,33,34,35,36,37,38,39,40,41,42,42,41,40,39,38,37,36,35,34,33,32,31,30,29,28,27,26,25,24,23,22,21,20,19,18,17,16,15,14,13,12,11,10,9,8,7,6,6,7,8,9,10,11,12,13,14,15,16,17,18,19,20,21,22
25,24,23,22,21,20,19,18,17,16,15,14,13,12,11,10,9,8,7,7,8,9,10,11,12,13,14,15,16,17,18,19,20,21,22,23,24,25,26,27,28,29,30,31,32,33,34,35,36,37,38,39,40,41,42,43,43,42,41,40,39,38,37,36,35,34,33,32,31,30,29,28,27,26,25,24,23,22,21,20,19,18,17,16,15,14,13,12,11,10,9,8,7,7,8,9,10,11,12,13,14,15,16,17,18,19,20,21,22,23
26,25,24,23,22,21,20,19,18,17,16,15,14,13,12,11,10,9,8,8,9,10,11,12,13,14,15,16,17,18,19,20,21,22,23,24,25,26,27,28,29,30,31,32,33,34,35,36,37,38,39,40,41,42,43,44,44,43,42,41,40,39,38,37,36,35,34,33,32,31,30,29,28,27,26,25,24,23,22,21,20,19,18,17,16,15,14,13,12,11,10,9,8,8,9,10,11,12,13,14,15,16,17,18,19,20,21,22,23,24
27,26,25,24,23,22,21,20,19,18,17,16,15,14,13,12,11,10,9,9,10,11,12,13,14,15,16,17,18,19,20,21,22,23,24,25,26,27,28,29,30,31,32,33,34,35,36,37,38,39,40,41,42,43,44,45,45,44,43,42,41,40,39,38,37,36,35,34,33,32,31,30,29,28,27,26,25,24,23,22,21,20,19,18,17,16,15,14,13,12,11,10,9,9,10,11,12,13,14,15,16,17,18,19,20,21,22,23,24,25
28,27,26,25,24,23,22,21,20,19,18,17,16,15,14,13,12,11,10,10,11,12,13,14,15,16,17,18,19,20,21,22,23,24,25,26,27,28,29,30,31,32,33,34,35,36,37,38,39,40,41,42,43,44,45,46,46,45,44,43,42,41,40,39,38,37,36,35,34,33,32,31,30,29,28,27,26,25,24,23,22,21,20,19,18,17,16,15,14,13,12,11,10,10,11,12,13,14,15,16,17,18,19,20,21,22,23,24,25,26
29,28,27,26,25,24,23,22,21,20,19,18,17,16,15,14,13,12,11,11,12,13,14,15,16,17,18,19,20,21,22,23,24,25,26,27,28,29,30,31,32,33,34,35,36,37,38,39,40,41,42,43,44,45,46,47,47,46,45,44,43,42,41,40,39,38,37,36,35,34,33,32,31,30,29,28,27,26,25,24,23,22,21,20,19,18,17,16,15,14,13,12,11,11,12,13,14,15,16,17,18,19,20,21,22,23,24,25,26,27
30,29,28,27,26,25,24,23,22,21,20,19,18,17,16,15,14,13,12,12,13,14,15,16,17,18,19,20,21,22,23,24,25,26,27,28,29,30,31,32,33,34,35,36,37,38,39,40,41,42,43,44,45,46,47,48,48,47,46,45,44,43,42,41,40,39,38,37,36,35,34,33,32,31,30,29,28,27,26,25,24,23,22,21,20,19,18,17,16,15,14,13,12,12,13,14,15,16,17,18,19,20,21,22,23,24,25,26,27,28
31,30,29,28,27,26,25,24,23,22,21,20,19,18,17,16,15,14,13,13,14,15,16,17,18,19,20,21,22,23,24,25,26,27,28,29,30,31,32,33,34,35,36,37,38,39,40,41,42,43,44,45,46,47,48,49,49,48,47,46,45,44,43,42,41,40,39,38,37,36,35,34,33,32,31,30,29,28,27,26,25,24,23,22,21,20,19,18,17,16,15,14,13,13,14,15,16,17,18,19,20,21,22,23,24,25,26,27,28,29
32,31,30,29,28,27,26,25,24,23,22,21,20,19,18,17,16,15,14,14,15,16,17,18,19,20,21,22,23,24,25,26,27,28,29,30,31,32,33,34,35,36,37,38,39,40,41,42,43,44,45,46,47,48,49,50,50,49,48,47,46,45,44,43,42,41,40,39,38,37,36,35,34,33,32,31,30,29,28,27,26,25,24,23,22,21,20,19,18,17,16,15,14,14,15,16,17,18,19,20,21,22,23,24,25,26,27,28,29,30
33,32,31,30,29,28,27,26,25,24,23,22,21,20,19,18,17,16,15,15,16,17,18,19,20,21,22,23,24,25,26,27,28,29,30,31,32,33,34,35,36,37,38,39,40,41,42,43,44,45,46,47,48,49,50,51,51,50,49,48,47,46,45,44,43,42,41,40,39,38,37,36,35,34,33,32,31,30,29,28,27,26,25,24,23,22,21,20,19,18,17,16,15,15,16,17,18,19,20,21,22,23,24,25,26,27,28,29,30,31
34,33,32,31,30,29,28,27,26,25,24,23,22,21,20,19,18,17,16,16,17,18,19,20,21,22,23,24,25,26,27,28,29,30,31,32,33,34,35,36,37,38,39,40,41,42,43,44,45,46,47,48,49,50,51,52,52,51,50,49,48,47,46,45,44,43,42,41,40,39,38,37,36,35,34,33,32,31,30,29,28,27,26,25,24,23,22,21,20,19,18,17,16,16,17,18,19,20,21,22,23,24,25,26,27,28,29,30,31,32
35,34,33,32,31,30,29,28,27,26,25,24,23,22,21,20,19,18,17,17,18,19,20,21,22,23,24,25,26,27,28,29,30,31,32,33,34,35,36,37,38,39,40,41,42,43,44,45,46,47,48,49,50,51,52,53,53,52,51,50,49,48,47,46,45,44,43,42,41,40,39,38,37,36,35,34,33,32,31,30,29,28,27,26,25,24,23,22,21,20,19,18,17,17,18,19,20,21,22,23,24,25,26,27,28,29,30,31,32,33
36,35,34,33,32,31,30,29,28,27,26,25,24,23,22,21,20,19,18,18,19,20,21,22,23,24,25,26,27,28,29,30,31,32,33,34,35,36,37,38,39,40,41,42,43,44,45,46,47,48,49,50,51,52,53,54,54,53,52,51,50,49,48,47,46,45,44,43,42,41,40,39,38,37,36,35,34,33,32,31,30,29,28,27,26,25,24,23,22,21,20,19,18,18,19,20,21,22,23,24,25,26,27,28,29,30,31,32,33,34
37,36,35,34,33,32,31,30,29,28,27,26,25,24,23,22,21,20,19,19,20,21,22,23,24,25,26,27,28,29,30,31,32,33,34,35,36,37,38,39,40,41,42,43,44,45,46,47,48,49,50,51,52,53,54,55,55,54,53,52,51,50,49,48,47,46,45,44,43,42,41,40,39,38,37,36,35,34,33,32,31,30,29,28,27,26,25,24,23,22,21,20,19,19,20,21,22,23,24,25,26,27,28,29,30,31,32,33,34,35
38,37,36,35,34,33,32,31,30,29,28,27,26,25,24,23,22,21,20,20,21,22,23,24,25,26,27,28,29,30,31,32,33,34,35,36,37,38,39,40,41,42,43,44,45,46,47,48,49,50,51,52,53,54,55,56,56,55,54,53,52,51,50,49,48,47,46,45,44,43,42,41,40,39,38,37,36,35,34,33,32,31,30,29,28,27,26,25,24,23,22,21,20,20,21,22,23,24,25,26,27,28,29,30,31,32,33,34,35,36
39,38,37,36,35,34,33,32,31,30,29,28,27,26,25,24,23,22,21,21,22,23,24,25,26,27,28,29,30,31,32,33,34,35,36,37,38,39,40,41,42,43,44,45,46,47,48,49,50,51,52,53,54,55,56,57,57,56,55,54,53,52,51,50,49,48,47,46,45,44,43,42,41,40,39,38,37,36,35,34,33,32,31,30,29,28,27,26,25,24,23,22,21,21,22,23,24,25,26,27,28,29,30,31,32,33,34,35,36,37
40,39,38,37,36,35,34,33,32,31,30,29,28,27,26,25,24,23,22,22,23,24,25,26,27,28,29,30,31,32,33,34,35,36,37,38,39,40,41,42,43,44,45,46,47,48,49,50,51,52,53,54,55,56,57,58,58,57,56,55,54,53,52,51,50,49,48,47,46,45,44,43,42,41,40,39,38,37,36,35,34,33,32,31,30,29,28,27,26,25,24,23,22,22,23,24,25,26,27,28,29,30,31,32,33,34,35,36,37,38
41,40,39,38,37,36,35,34,33,32,31,30,29,28,27,26,25,24,23,23,24,25,26,27,28,29,30,31,32,33,34,35,36,37,38,39,40,41,42,43,44,45,46,47,48,48,49,50,51,52,53,54,55,56,57,58,59,58,57,56,55,54,53,52,51,50,49,48,47,46,45,44,43,42,41,40,39,38,37,36,35,34,33,32,31,30,29,28,27,26,25,24,23,23,24,25,26,27,28,29,30,31,32,33,34,35,36,37,38,39
42,41,40,39,38,37,36,35,34,33,32,31,30,29,28,27,26,25,24,24,25,26,27,28,29,30,31,32,33,34,35,36,37,38,39,40,41,42,43,44,45,46,47,48,47,47,48,49,50,51,52,53,54,55,56,57,58,59,58,57,56,55,54,53,52,51,50,49,48,47,46,45,44,43,42,41,40,39,38,37,36,35,34,33,32,31,30,29,28,27,26,25,24,24,25,26,27,28,29,30,31,32,33,34,35,36,37,38,39,40
42,42,41,40,39,38,37,36,35,34,33,32,31,30,29,28,27,26,25,25,26,27,28,29,30,31,32,33,34,35,36,37,38,39,40,41,42,43,44,45,46,47,48,47,46,46,47,48,49,50,51,52,53,54,55,56,57,58,59,58,57,56,55,54,53,52,51,50,49,48,47,46,45,44,43,42,41,40,39,38,37,36,35,34,33,32,31,30,29,28,27,26,25,25,26,27,28,29,30,31,32,33,34,35,36,37,38,39,40,41
41,42,42,41,40,39,38,37,36,35,34,33,32,31,30,29,28,27,26,26,27,28,29,30,31,32,33,34,35,36,37,38,39,40,41,42,43,44,45,46,47,48,47,46,45,45,46,47,48,49,50,51,52,53,54,55,56,57,58,59,58,57,56,55,54,53,52,51,50,49,48,47,46,45,44,43,42,41,40,39,38,37,36,35,34,33,32,31,30,29,28,27,26,26,27,28,29,30,31,32,33,34,35,36,37,38,39,40,41,42
40,41,42,42,41,40,39,38,37,36,35,34,33,32,31,30,29,28,27,27,28,29,30,31,32,33,34,35,36,37,38,39,40,41,42,43,44,45,46,47,48,47,46,45,44,44,45,46,47,48,49,50,51,52,53,54,55,56,57,58,59,58,57,56,55,54,53,52,51,50,49,48,47,46,45,44,43,42,41,40,39,38,37,36,35,34,33,32,31,30,29,28,27,27,28,29,30,31,32,33,34,35,36,37,38,39,40,41,42,43
39,40,41,42,42,41,40,39,38,37,36,35,34,33,32,31,30,29,28,28,29,30,31,32,33,34,35,36,37,38,39,40,41,42,43,44,45,46,47,48,47,46,45,44,43,43,44,45,46,47,48,49,50,51,52,53,54,55,56,57,58,59,58,57,56,55,54,53,52,51,50,49,48,47,46,45,44,43,42,41,40,39,38,37,36,35,34,33,32,31,30,29,28,28,29,30,31,32,33,34,35,36,37,38,39,40,41,42,43,44
38,39,40,41,42,42,41,40,39,38,37,36,35,34,33,32,31,30,29,29,30,31,32,33,34,35,36,37,38,39,40,41,42,43,44,45,46,47,48,47,46,45,44,43,42,42,43,44,45,46,47,48,49,50,51,52,53,54,55,56,57,58,59,58,57,56,55,54,53,52,51,50,49,48,47,46,45,44,43,42,41,40,39,38,37,36,35,34,33,32,31,30,29,29,30,31,32,33,34,35,36,37,38,39,40,41,42,43,44,45
37,38,39,40,41,42,42,41,40,39,38,37,36,35,34,33,32,31,30,30,31,32,33,34,35,36,37,38,39,40,41,42,43,44,45,46,47,48,47,46,45,44,43,42,41,41,42,43,44,45,46,47,48,49,50,51,52,53,54,55,56,57,58,59,58,57,56,55,54,53,52,51,50,49,48,47,46,45,44,43,42,41,40,39,38,37,36,35,34,33,32,31,30,30,31,32,33,34,35,36,37,38,39,40,41,42,43,44,45,46
36,37,38,39,40,41,42,42,41,40,39,38,37,36,35,34,33,32,31,31,32,33,34,35,36,37,38,39,40,41,42,43,44,45,46,47,48,47,46,45,44,43,42,41,40,40,41,42,43,44,45,46,47,48,49,50,51,52,53,54,55,56,57,58,59,58,57,56,55,54,53,52,51,50,49,48,47,46,45,44,43,42,41,40,39,38,37,36,35,34,33,32,31,31,32,33,34,35,36,37,38,39,40,41,42,43,44,45,46,47
35,36,37,38,39,40,41,42,42,41,40,39,38,37,36,35,34,33,32,32,33,34,35,36,37,38,39,40,41,42,43,44,45,46,47,48,47,46,45,44,43,42,41,40,39,39,40,41,42,43,44,45,46,47,48,49,50,51,52,53,54,55,56,57,58,59,58,57,56,55,54,53,52,51,50,49,48,47,46,45,44,43,42,41,40,39,38,37,36,35,34,33,32,32,33,34,35,36,37,38,39,40,41,42,43,44,45,46,47,48
34,35,36,37,38,39,40,41,42,42,41,40,39,38,37,36,35,34,33,33,34,35,36,37,38,39,40,41,42,43,44,45,46,47,48,47,46,45,44,43,42,41,40,39,38,38,39,40,41,42,43,44,45,46,47,48,49,50,51,52,53,54,55,56,57,58,59,58,57,56,55,54,53,52,51,50,49,48,47,46,45,44,43,42,41,40,39,38,37,36,35,34,33,33,34,35,36,37,38,39,40,41,42,43,44,45,46,47,48,49
33,34,35,36,37,38,39,40,41,42,42,41,40,39,38,37,36,35,34,34,35,36,37,38,39,40,41,42,43,44,45,46,47,48,47,46,45,44,43,42,41,40,39,38,37,37,38,39,40,41,42,43,44,45,46,47,48,49,50,51,52,53,54,55,56,57,58,59,58,57,56,55,54,53,52,51,50,49,48,47,46,45,44,43,42,41,40,39,38,37,36,35,34,34,35,36,37,38,39,40,41,42,43,44,45,46,47,48,49,50
32,33,34,35,36,37,38,39,40,41,42,42,41,40,39,38,37,36,35,35,36,37,38,39,40,41,42,43,44,45,46,47,48,47,46,45,44,43,42,41,40,39,38,37,36,36,37,38,39,40,41,42,43,44,45,46,47,48,49,50,51,52,53,54,55,56,57,58,59,58,57,56,55,54,53,52,51,50,49,48,47,46,45,44,43,42,41,40,39,38,37,36,35,35,36,37,38,39,40,41,42,43,44,45,46,47,48,49,50,51
31,32,33,34,35,36,37,38,39,40,41,42,42,41,40,39,38,37,36,36,37,38,39,40,41,42,43,44,45,46,47,48,47,46,45,44,43,42,41,40,39,38,37,36,35,35,36,37,38,39,40,41,42,43,44,45,46,47,48,49,50,51,52,53,54,55,56,57,58,59,58,57,56,55,54,53,52,51,50,49,48,47,46,45,44,43,42,41,40,39,38,37,36,36,37,38,39,40,41,42,43,44,45,46,47,48,49,50,51,52
30,31,32,33,34,35,36,37,38,39,40,41,42,42,41,40,39,38,37,37,38,39,40,41,42,43,44,45,46,47,48,47,46,45,44,43,42,41,40,39,38,37,36,35,34,34,35,36,37,38,39,40,41,42,43,44,45,46,47,48,49,50,51,52,53,54,55,56,57,58,59,58,57,56,55,54,53,52,51,50,49,48,47,46,45,44,43,42,41,40,39,38,37,37,38,39,40,41,42,43,44,45,46,47,48,49,50,51,52,53
29,30,31,32,33,34,35,36,37,38,39,40,41,42,42,41,40,39,38,38,39,40,41,42,43,44,45,46,47,48,47,46,45,44,43,42,41,40,39,38,37,36,35,34,33,33,34,35,36,37,38,39,40,41,42,43,44,45,46,47,48,49,50,51,52,53,54,55,56,57,58,59,58,57,56,55,54,53,52,51,50,49,48,47,46,45,44,43,42,41,40,39,38,38,39,40,41,42,43,44,45,46,47,48,49,50,51,52,53,54
28,29,30,31,32,33,34,35,36,37,38,39,40,41,42,42,41,40,39,39,40,41,42,43,44,45,46,47,48,47,46,45,44,43,42,41,40,39,38,37,36,35,34,33,32,32,33,34,35,36,37,38,39,40,41,42,43,44,45,46,47,48,49,50,51,52,53,54,55,56,57,58,59,58,57,56,55,54,53,52,51,50,49,48,47,46,45,44,43,42,41,40,39,39,40,41,42,43,44,45,46,47,48,49,50,51,52,53,54,55
27,28,29,30,31,32,33,34,35,36,37,38,39,40,41,42,42,41,40,40,41,42,43,44,45,46,47,48,47,46,45,44,43,42,41,40,39,38,37,36,35,34,33,32,31,31,32,33,34,35,36,37,38,39,40,41,42,43,44,45,46,47,48,49,50,51,52,53,54,55,56,57,58,59,58,57,56,55,54,53,52,51,50,49,48,47,46,45,44,43,42,41,40,40,41,42,43,44,45,46,47,48,49,50,51,52,53,54,55,56
26,27,28,29,30,31,32,33,34,35,36,37,38,39,40,41,42,42,41,41,42,43,44,45,46,47,48,47,46,45,44,43,42,41,40,39,38,37,36,35,34,33,32,31,30,30,31,32,33,34,35,36,37,38,39,40,41,42,43,44,45,46,47,48,49,50,51,52,53,54,55,56,57,58,59,58,57,56,55,54,53,52,51,50,49,48,47,46,45,44,43,42,41,41,42,43,44,45,46,47,48,49,50,51,52,53,54,55,56,57
25,26,27,28,29,30,31,32,33,34,35,36,37,38,39,40,41,42,42,42,43,44,45,46,47,48,47,46,45,44,43,42,41,40,39,38,37,36,35,34,33,32,31,30,29,29,30,31,32,33,34,35,36,37,38,39,40,41,42,43,44,45,46,47,48,49,50,51,52,53,54,55,56,57,58,59,58,57,56,55,54,53,52,51,50,49,48,47,46,45,44,43,42,42,43,44,45,46,47,48,49,50,51,52,53,54,55,56,57,58
24,25,26,27,28,29,30,31,32,33,34,35,36,37,38,39,40,41,42,43,44,45,46,47,48,47,46,45,44,43,42,41,40,39,38,37,36,35,34,33,32,31,30,29,28,28,29,30,31,32,33,34,35,36,37,38,39,40,41,42,43,44,45,46,47,48,49,50,51,52,53,54,55,56,57,58,59,58,57,56,55,54,53,52,51,50,49,48,47,46,45,44,43,43,44,45,46,47,48,49,50,51,52,53,54,55,56,57,58,59
23,24,25,26,27,28,29,30,31,32,33,34,35,36,37,38,39,40,41,42,43,44,45,46,47,46,45,44,43,42,41,40,39,38,37,36,35,34,33,32,31,30,29,28,27,27,28,29,30,31,32,33,34,35,36,37,38,39,40,41,42,43,44,45,46,47,48,49,50,51,52,53,54,55,56,57,58,59,58,57,56,55,54,53,52,51,50,49,48,47,46,45,44,44,45,46,47,48,49,50,51,52,53,54,55,56,57,58,59,60
22,23,24,25,26,27,28,29,30,31,32,33,34,35,36,37,38,39,40,41,42,43,44,45,46,45,44,43,42,41,40,39,38,37,36,35,34,33,32,31,30,29,28,27,26,26,27,28,29,30,31,32,33,34,35,36,37,38,39,40,41,42,43,44,45,46,47,48,49,50,51,52,53,54,55,56,57,58,59,58,57,56,55,54,53,52,51,50,49,48,47,46,45,45,46,47,48,49,50,51,52,53,54,55,56,57,58,59,60,61
21,22,23,24,25,26,27,28,29,30,31,32,33,34,35,36,37,38,39,40,41,42,43,44,45,44,43,42,41,40,39,38,37,36,35,34,33,32,31,30,29,28,27,26,25,25,26,27,28,29,30,31,32,33,34,35,36,37,38,39,40,41,42,43,44,45,46,47,48,49,50,51,52,53,54,55,56,57,58,59,58,57,56,55,54,53,52,51,50,49,48,47,46,46,47,48,49,50,51,52,53,54,55,56,57,58,59,60,61,62
20,21,22,23,24,25,26,27,28,29,30,31,32,33,34,35,36,37,38,39,40,41,42,43,44,43,42,41,40,39,38,37,36,35,34,33,32,31,30,29,28,27,26,25,24,24,25,26,27,28,29,30,31,32,33,34,35,36,37,38,39,40,41,42,43,44,45,46,47,48,49,50,51,52,53,54,55,56,57,58,59,58,57,56,55,54,53,52,51,50,49,48,47,47,48,49,50,51,52,53,54,55,56,57,58,59,60,61,62,63
19,20,21,22,23,24,25,26,27,28,29,30,31,32,33,34,35,36,37,38,39,40,41,42,43,42,41,40,39,38,37,36,35,34,33,32,31,30,29,28,27,26,25,24,23,23,24,25,26,27,28,29,30,31,32,33,34,35,36,37,38,39,40,41,42,43,44,45,46,47,48,49,50,51,52,53,54,55,56,57,58,59,58,57,56,55,54,53,52,51,50,49,48,48,49,50,51,52,53,54,55,56,57,58,59,60,61,62,63,64
18,19,20,21,22,23,24,25,26,27,28,29,30,31,32,33,34,35,36,37,38,39,40,41,42,41,40,39,38,37,36,35,34,33,32,31,30,29,28,27,26,25,24,23,22,22,23,24,25,26,27,28,29,30,31,32,33,34,35,36,37,38,39,40,41,42,43,44,45,46,47,48,49,50,51,52,53,54,55,56,57,58,59,58,57,56,55,54,53,52,51,50,49,49,50,51,52,53,54,55,56,57,58,59,60,61,62,63,64,65
17,18,19,20,21,22,23,24,25,26,27,28,29,30,31,32,33,34,35,36,37,38,39,40,41,40,39,38,37,36,35,34,33,32,31,30,29,28,27,26,25,24,23,22,21,21,22,23,24,25,26,27,28,29,30,31,32,33,34,35,36,37,38,39,40,41,42,43,44,45,46,47,48,49,50,51,52,53,54,55,56,57,58,59,58,57,56,55,54,53,52,51,50,50,51,52,53,54,55,56,57,58,59,60,61,62,63,64,65,66
16,17,18,19,20,21,22,23,24,25,26,27,28,29,30,31,32,33,34,35,36,37,38,39,40,39,38,37,36,35,34,33,32,31,30,29,28,27,26,25,24,23,22,21,20,20,21,22,23,24,25,26,27,28,29,30,31,32,33,34,35,36,37,38,39,40,41,42,43,44,45,46,47,48,49,50,51,52,53,54,55,56,57,58,59,58,57,56,55,54,53,52,51,51,52,53,54,55,56,57,58,59,60,61,62,63,64,65,66,67
15,16,17,18,19,20,21,22,23,24,25,26,27,28,29,30,31,32,33,34,35,36,37,38,39,38,37,36,35,34,33,32,31,30,29,28,27,26,25,24,23,22,21,20,19,19,20,21,22,23,24,25,26,27,28,29,30,31,32,33,34,35,36,37,38,39,40,41,42,43,44,45,46,47,48,49,50,51,52,53,54,55,56,57,58,59,58,57,56,55,54,53,52,52,53,54,55,56,57,58,59,60,61,62,63,64,65,66,67,68
14,15,16,17,18,19,20,21,22,23,24,25,26,27,28,29,30,31,32,33,34,35,36,37,38,37,36,35,34,33,32,31,30,29,28,27,26,25,24,23,22,21,20,19,18,18,19,20,21,22,23,24,25,26,27,28,29,30,31,32,33,34,35,36,37,38,39,40,41,42,43,44,45,46,47,48,49,50,51,52,53,54,55,56,57,58,59,58,57,56,55,54,53,53,54,55,56,57,58,59,60,61,62,63,64,65,66,67,68,69
13,14,15,16,17,18,19,20,21,22,23,24,25,26,27,28,29,30,31,32,33,34,35,36,37,36,35,34,33,32,31,30,29,28,27,26,25,24,23,22,21,20,19,18,17,17,18,19,20,21,22,23,24,25,26,27,28,29,30,31,32,33,34,35,36,37,38,39,40,41,42,43,44,45,46,47,48,49,50,51,52,53,54,55,56,57,58,59,58,57,56,55,54,54,55,56,57,58,59,60,61,62,63,64,65,66,67,68,69,70
12,13,14,15,16,17,18,19,20,21,22,23,24,25,26,27,28,29,30,31,32,33,34,35,36,35,34,33,32,31,30,29,28,27,26,25,24,23,22,21,20,19,18,17,16,16,17,18,19,20,21,22,23,24,25,26,27,28,29,30,31,32,33,34,35,36,37,38,39,40,41,42,43,44,45,46,47,48,49,50,51,52,53,54,55,56,57,58,59,58,57,56,55,55,56,57,58,59,60,61,62,63,64,65,66,67,68,69,70,71
11,12,13,14,15,16,17,18,19,20,21,22,23,24,25,26,27,28,29,30,31,32,33,34,35,34,33,32,31,30,29,28,27,26,25,24,23,22,21,20,19,18,17,16,15,15,16,17,18,19,20,21,22,23,24,25,26,27,28,29,30,31,32,33,34,35,36,37,38,39,40,41,42,43,44,45,46,47,48,49,50,51,52,53,54,55,56,57,58,59,58,57,56,56,57,58,59,60,61,62,63,64,65,66,67,68,69,70,71,72
10,11,12,13,14,15,16,17,18,19,20,21,22,23,24,25,26,27,28,29,30,31,32,33,34,33,32,31,30,29,28,27,26,25,24,23,22,21,20,19,18,17,16,15,14,14,15,16,17,18,19,20,21,22,23,24,25,26,27,28,29,30,31,32,33,34,35,36,37,38,39,40,41,42,43,44,45,46,47,48,49,50,51,52,53,54,55,56,57,58,59,58,57,57,58,59,60,61,62,63,64,65,66,67,68,69,70,71,72,73
9,10,11,12,13,14,15,16,17,18,19,20,21,22,23,24,25,26,27,28,29,30,31,32,33,32,31,30,29,28,27,26,25,24,23,22,21,20,19,18,17,16,15,14,13,13,14,15,16,17,18,19,20,21,22,23,24,25,26,27,28,29,30,31,32,33,34,35,36,37,38,39,40,41,42,43,44,45,46,47,48,49,50,51,52,53,54,55,56,57,58,59,58,58,59,60,61,62,63,64,65,66,67,68,69,70,71,72,73,74
8,9,10,11,12,13,14,15,16,17,18,19,20,21,22,23,24,25,26,27,28,29,30,31,32,31,30,29,28,27,26,25,24,23,22,21,20,19,18,17,16,15,14,13,12,12,13,14,15,16,17,18,19,20,21,22,23,24,25,26,27,28,29,30,31,32,33,34,35,36,37,38,39,40,41,42,43,44,45,46,47,48,49,50,51,52,53,54,55,56,57,58,59,59,60,61,62,63,64,65,66,67,68,69,70,71,72,73,74,75
7,8,9,10,11,12,13,14,15,16,17,18,19,20,21,22,23,24,25,26,27,28,29,30,31,30,29,28,27,26,25,24,23,22,21,20,19,18,17,16,15,14,13,12,11,11,12,13,14,15,16,17,18,19,20,21,22,23,24,25,26,27,28,29,30,31,32,33,34,35,36,37,38,39,40,41,42,43,44,45,46,47,48,49,50,51,52,53,54,55,56,57,58,59,60,61,62,63,64,65,66,67,68,69,70,71,72,73,74,75
6,7,8,9,10,11,12,13,14,15,16,17,18,19,20,21,22,23,24,25,26,27,28,29,30,29,28,27,26,25,24,23,22,21,20,19,18,17,16,15,14,13,12,11,10,10,11,12,13,14,15,16,17,18,19,20,21,22,23,24,25,26,27,28,29,30,31,32,33,34,35,36,37,38,39,40,41,42,43,44,45,46,47,48,49,50,51,52,53,54,55,56,57,58,59,60,61,62,63,64,65,66,67,68,69,70,71,72,73,74
5,6,7,8,9,10,11,12,13,14,15,16,17,18,19,20,21,22,23,24,25,26,27,28,29,28,27,26,25,24,23,22,21,20,19,18,17,16,15,14,13,12,11,10,9,9,10,11,12,13,14,15,16,17,18,19,20,21,22,23,24,25,26,27,28,29,30,31,32,33,34,35,36,37,38,39,40,41,42,43,44,45,46,47,48,49,50,51,52,53,54,55,56,57,58,59,60,61,62,63,64,65,66,67,68,69,70,71,72,73
4,5,6,7,8,9,10,11,12,13,14,15,16,17,18,19,20,21,22,23,24,25,26,27,28,27,26,25,24,23,22,21,20,19,18,17,16,15,14,13,12,11,10,9,8,8,9,10,11,12,13,14,15,16,17,18,19,20,21,22,23,24,25,26,27,28,29,30,31,32,33,34,35,36,37,38,39,40,41,42,43,44,45,46,47,48,49,50,51,52,53,54,55,56,57,58,59,60,61,62,63,64,65,66,67,68,69,70,71,72
3,4,5,6,7,8,9,10,11,12,13,14,15,16,17,18,19,20,21,22,23,24,25,26,27,26,25,24,23,22,21,20,19,18,17,16,15,14,13,12,11,10,9,8,7,7,8,9,10,11,12,13,14,15,16,17,18,19,20,21,22,23,24,25,26,27,28,29,30,31,32,33,34,35,36,37,38,39,40,41,42,43,44,45,46,47,48,49,50,51,52,53,54,55,56,57,58,59,60,61,62,63,64,65,66,67,68,69,70,71
2,3,4,5,6,7,8,9,10,11,12,13,14,15,16,17,18,19,20,21,22,23,24,25,26,25,24,23,22,21,20,19,18,17,16,15,14,13,12,11,10,9,8,7,6,6,7,8,9,10,11,12,13,14,15,16,17,18,19,20,21,22,23,24,25,26,27,28,29,30,31,32,33,34,35,36,37,38,39,40,41,42,43,44,45,46,47,48,49,50,51,52,53,54,55,56,57,58,59,60,61,62,63,64,65,66,67,68,69,70
1,2,3,4,5,6,7,8,9,10,11,12,13,14,15,16,17,18,19,20,21,22,23,24,25,24,23,22,21,20,19,18,17,16,15,14,13,12,11,10,9,8,7,6,5,5,6,7,8,9,10,11,12,13,14,15,16,17,18,19,20,21,22,23,24,25,26,27,28,29,30,31,32,33,34,35,36,37,38,39,40,41,42,43,44,45,46,47,48,49,50,51,52,53,54,55,56,57,58,59,60,61,62,63,64,65,66,67,68,69
0,1,2,3,4,5,6,7,8,9,10,11,12,13,14,15,16,17,18,19,20,21,22,23,24,23,22,21,20,19,18,17,16,15,14,13,12,11,10,9,8,7,6,5,4,4,5,6,7,8,9,10,11,12,13,14,15,16,17,18,19,20,21,22,23,24,25,26,27,28,29,30,31,32,33,34,35,36,37,38,39,40,41,42,43,44,45,46,47,48,49,50,51,52,53,54,55,56,57,58,59,60,61,62,63,64,65,66,67,68
0,1,2,3,4,5,6,7,8,9,10,11,12,13,14,15,16,17,18,19,20,21,22,23,23,22,21,20,19,18,17,16,15,14,13,12,11,10,9,8,7,6,5,4,3,3,4,5,6,7,8,9,10,11,12,13,14,15,16,17,18,19,20,21,22,23,24,25,26,27,28,29,30,31,32,33,34,35,36,37,38,39,40,41,42,43,44,45,46,47,48,49,50,51,52,53,54,55,56,57,58,59,60,61,62,63,64,65,66,67
0,1,2,3,4,5,6,7,8,9,10,11,12,13,14,15,16,17,18,19,20,21,22,23,22,21,20,19,18,17,16,15,14,13,12,11,10,9,8,7,6,5,4,3,2,2,3,4,5,6,7,8,9,10,11,12,13,14,15,16,17,18,19,20,21,22,23,24,25,26,27,28,29,30,31,32,33,34,35,36,37,38,39,40,41,42,43,44,45,46,47,48,49,50,51,52,53,54,55,56,57,58,59,60,61,62,63,64,65,66
0,1,2,3,4,5,6,7,8,9,10,11,12,13,14,15,16,17,18,19,20,21,22,22,21,20,19,18,17,16,15,14,13,12,11,10,9,8,7,6,5,4,3,2,1,1,2,3,4,5,6,7,8,9,10,11,12,13,14,15,16,17,18,19,20,21,22,23,24,25,26,27,28,29,30,31,32,33,34,35,36,37,38,39,40,41,42,43,44,45,46,47,48,49,50,51,52,53,54,55,56,57,58,59,60,61,62,63,64,65
0,1,2,3,4,5,6,7,8,9,10,11,12,13,14,15,16,17,18,19,20,21,22,21,20,19,18,17,16,15,14,13,12,11,10,9,8,7,6,5,4,3,2,1,0,0,1,2,3,4,5,6,7,8,9,10,11,12,13,14,15,16,17,18,19,20,21,22,23,24,25,26,27,28,29,30,31,32,33,34,35,36,37,38,39,40,41,42,43,44,45,46,47,48,49,50,51,52,53,54,55,56,57,58,59,60,61,62,63,64
