18,17,16,15,14,13,12,11,10,9,8,7,6,5,4,3,2,1,0,1,2,3,4,5,6,7,8,9,10,11,12,13,14,15,16,17,18,19,20,21,22,23,24,25,26,27,28,29,30,31,32,33,34,35,36,37,36,35,34,33,32,31,30,29,28,27,26,25,24,23,22,21,20,19,18,17,16,15,14,13,12,11,10,9,8,7,6,5,4,3,2,1,0,1,2,3,4,5,6,7,8,9,10,11,12,13,14,15,16,17,
19,18,17,16,15,14,13,12,11,10,9,8,7,6,5,4,3,2,1,2,3,4,5,6,7,8,9,10,11,12,13,14,15,16,17,18,19,20,21,22,23,24,25,26,27,28,29,30,31,32,33,34,35,36,37,38,37,36,35,34,33,32,31,30,29,28,27,26,25,24,23,22,21,20,19,18,17,16,15,14,13,12,11,10,9,8,7,6,5,4,3,2,1,2,3,4,5,6,7,8,9,10,11,12,13,14,15,16,17,18,
20,19,18,17,16,15,14,13,12,11,10,9,8,7,6,5,4,3,2,3,4,5,6,7,8,9,10,11,12,13,14,15,16,17,18,19,20,21,22,23,24,25,26,27,28,29,30,31,32,33,34,35,36,37,38,39,38,37,36,35,34,33,32,31,30,29,28,27,26,25,24,23,22,21,20,19,18,17,16,15,14,13,12,11,10,9,8,7,6,5,4,3,2,3,4,5,6,7,8,9,10,11,12,13,14,15,16,17,18,19,
21,20,19,18,17,16,15,14,13,12,11,10,9,8,7,6,5,4,3,4,5,6,7,8,9,10,11,12,13,14,15,16,17,18,19,20,21,22,23,24,25,26,27,28,29,30,31,32,33,34,35,36,37,38,39,40,39,38,37,36,35,34,33,32,31,30,29,28,27,26,25,24,23,22,21,20,19,18,17,16,15,14,13,12,11,10,9,8,7,6,5,4,3,4,5,6,7,8,9,10,11,12,13,14,15,16,17,18,19,20,
22,21,20,19,18,17,16,15,14,13,12,11,10,9,8,7,6,5,4,5,6,7,8,9,10,11,12,13,14,15,16,17,18,19,20,21,22,23,24,25,26,27,28,29,30,31,32,33,34,35,36,37,38,39,40,41,40,39,38,37,36,35,34,33,32,31,30,29,28,27,26,25,24,23,22,21,20,19,18,17,16,15,14,13,12,11,10,9,8,7,6,5,4,5,6,7,8,9,10,11,12,13,14,15,16,17,18,19,20,21,
23,22,21,20,19,18,17,16,15,14,13,12,11,10,9,8,7,6,5,6,7,8,9,10,11,12,13,14,15,16,17,18,19,20,21,22,23,24,25,26,27,28,29,30,31,32,33,34,35,36,37,38,39,40,41,42,41,40,39,38,37,36,35,34,33,32,31,30,29,28,27,26,25,24,23,22,21,20,19,18,17,16,15,14,13,12,11,10,9,8,7,6,5,6,7,8,9,10,11,12,13,14,15,16,17,18,19,20,21,22,
24,23,22,21,20,19,18,17,16,15,14,13,12,11,10,9,8,7,6,7,8,9,10,11,12,13,14,15,16,17,18,19,20,21,22,23,24,25,26,27,28,29,30,31,32,33,34,35,36,37,38,39,40,41,42,43,42,41,40,39,38,37,36,35,34,33,32,31,30,29,28,27,26,25,24,23,22,21,20,19,18,17,16,15,14,13,12,11,10,9,8,7,6,7,8,9,10,11,12,13,14,15,16,17,18,19,20,21,22,23,
25,24,23,22,21,20,19,18,17,16,15,14,13,12,11,10,9,8,7,8,9,10,11,12,13,14,15,16,17,18,19,20,21,22,23,24,25,26,27,28,29,30,31,32,33,34,35,36,37,38,39,40,41,42,43,44,43,42,41,40,39,38,37,36,35,34,33,32,31,30,29,28,27,26,25,24,23,22,21,20,19,18,17,16,15,14,13,12,11,10,9,8,7,8,9,10,11,12,13,14,15,16,17,18,19,20,21,22,23,24,
26,25,24,23,22,21,20,19,18,17,16,15,14,13,12,11,10,9,8,9,10,11,12,13,14,15,16,17,18,19,20,21,22,23,24,25,26,27,28,29,30,31,32,33,34,35,36,37,38,39,40,41,42,43,44,45,44,43,42,41,40,39,38,37,36,35,34,33,32,31,30,29,28,27,26,25,24,23,22,21,20,19,18,17,16,15,14,13,12,11,10,9,8,9,10,11,12,13,14,15,16,17,18,19,20,21,22,23,24,25,
27,26,25,24,23,22,21,20,19,18,17,16,15,14,13,12,11,10,9,10,11,12,13,14,15,16,17,18,19,20,21,22,23,24,25,26,27,28,29,30,31,32,33,34,35,36,37,38,39,40,41,42,43,44,45,46,45,44,43,42,41,40,39,38,37,36,35,34,33,32,31,30,29,28,27,26,25,24,23,22,21,20,19,18,17,16,15,14,13,12,11,10,9,10,11,12,13,14,15,16,17,18,19,20,21,22,23,24,25,26,
28,27,26,25,24,23,22,21,20,19,18,17,16,15,14,13,12,11,10,11,12,13,14,15,16,17,18,19,20,21,22,23,24,25,26,27,28,29,30,31,32,33,34,35,36,37,38,39,40,41,42,43,44,45,46,47,46,45,44,43,42,41,40,39,38,37,36,35,34,33,32,31,30,29,28,27,26,25,24,23,22,21,20,19,18,17,16,15,14,13,12,11,10,11,12,13,14,15,16,17,18,19,20,21,22,23,24,25,26,27,
29,28,27,26,25,24,23,22,21,20,19,18,17,16,15,14,13,12,11,12,13,14,15,16,17,18,19,20,21,22,23,24,25,26,27,28,29,30,31,32,33,34,35,36,37,38,39,40,41,42,43,44,45,46,47,48,47,46,45,44,43,42,41,40,39,38,37,36,35,34,33,32,31,30,29,28,27,26,25,24,23,22,21,20,19,18,17,16,15,14,13,12,11,12,13,14,15,16,17,18,19,20,21,22,23,24,25,26,27,28,
30,29,28,27,26,25,24,23,22,21,20,19,18,17,16,15,14,13,12,13,14,15,16,17,18,19,20,21,22,23,24,25,26,27,28,29,30,31,32,33,34,35,36,37,38,39,40,41,42,43,44,45,46,47,48,49,48,47,46,45,44,43,42,41,40,39,38,37,36,35,34,33,32,31,30,29,28,27,26,25,24,23,22,21,20,19,18,17,16,15,14,13,12,13,14,15,16,17,18,19,20,21,22,23,24,25,26,27,28,29,
31,30,29,28,27,26,25,24,23,22,21,20,19,18,17,16,15,14,13,14,15,16,17,18,19,20,21,22,23,24,25,26,27,28,29,30,31,32,33,34,35,36,37,38,39,40,41,42,43,44,45,46,47,48,49,50,49,48,47,46,45,44,43,42,41,40,39,38,37,36,35,34,33,32,31,30,29,28,27,26,25,24,23,22,21,20,19,18,17,16,15,14,13,14,15,16,17,18,19,20,21,22,23,24,25,26,27,28,29,30,
32,31,30,29,28,27,26,25,24,23,22,21,20,19,18,17,16,15,14,15,16,17,18,19,20,21,22,23,24,25,26,27,28,29,30,31,32,33,34,35,36,37,38,39,40,41,42,43,44,45,46,47,48,49,50,51,50,49,48,47,46,45,44,43,42,41,40,39,38,37,36,35,34,33,32,31,30,29,28,27,26,25,24,23,22,21,20,19,18,17,16,15,14,15,16,17,18,19,20,21,22,23,24,25,26,27,28,29,30,31,
33,32,31,30,29,28,27,26,25,24,23,22,21,20,19,18,17,16,15,16,17,18,19,20,21,22,23,24,25,26,27,28,29,30,31,32,33,34,35,36,37,38,39,40,41,42,43,44,45,46,47,48,49,50,51,52,51,50,49,48,47,46,45,44,43,42,41,40,39,38,37,36,35,34,33,32,31,30,29,28,27,26,25,24,23,22,21,20,19,18,17,16,15,16,17,18,19,20,21,22,23,24,25,26,27,28,29,30,31,32,
34,33,32,31,30,29,28,27,26,25,24,23,22,21,20,19,18,17,16,17,18,19,20,21,22,23,24,25,26,27,28,29,30,31,32,33,34,35,36,37,38,39,40,41,42,43,44,45,46,47,48,49,50,51,52,53,52,51,50,49,48,47,46,45,44,43,42,41,40,39,38,37,36,35,34,33,32,31,30,29,28,27,26,25,24,23,22,21,20,19,18,17,16,17,18,19,20,21,22,23,24,25,26,27,28,29,30,31,32,33,
35,34,33,32,31,30,29,28,27,26,25,24,23,22,21,20,19,18,17,18,19,20,21,22,23,24,25,26,27,28,29,30,31,32,33,34,35,36,37,38,39,40,41,42,43,44,45,46,47,48,49,50,51,52,53,54,53,52,51,50,49,48,47,46,45,44,43,42,41,40,39,38,37,36,35,34,33,32,31,30,29,28,27,26,25,24,23,22,21,20,19,18,17,18,19,20,21,22,23,24,25,26,27,28,29,30,31,32,33,34,
36,35,34,33,32,31,30,29,28,27,26,25,24,23,22,21,20,19,18,19,20,21,22,23,24,25,26,27,28,29,30,31,32,33,34,35,36,37,38,39,40,41,42,43,44,45,46,47,48,49,50,51,52,53,54,55,54,53,52,51,50,49,48,47,46,45,44,43,42,41,40,39,38,37,36,35,34,33,32,31,30,29,28,27,26,25,24,23,22,21,20,19,18,19,20,21,22,23,24,25,26,27,28,29,30,31,32,33,34,35,
37,36,35,34,33,32,31,30,29,28,27,26,25,24,23,22,21,20,19,20,21,22,23,24,25,26,27,28,29,30,31,32,33,34,35,36,37,38,39,40,41,42,43,44,45,46,47,48,49,50,51,52,53,54,55,56,55,54,53,52,51,50,49,48,47,46,45,44,43,42,41,40,39,38,37,36,35,34,33,32,31,30,29,28,27,26,25,24,23,22,21,20,19,20,21,22,23,24,25,26,27,28,29,30,31,32,33,34,35,36,
38,37,36,35,34,33,32,31,30,29,28,27,26,25,24,23,22,21,20,21,22,23,24,25,26,27,28,29,30,31,32,33,34,35,36,37,38,39,40,41,42,43,44,45,46,47,48,49,50,51,52,53,54,55,56,57,56,55,54,53,52,51,50,49,48,47,46,45,44,43,42,41,40,39,38,37,36,35,34,33,32,31,30,29,28,27,26,25,24,23,22,21,20,21,22,23,24,25,26,27,28,29,30,31,32,33,34,35,36,37,
39,38,37,36,35,34,33,32,31,30,29,28,27,26,25,24,23,22,21,22,23,24,25,26,27,28,29,30,31,32,33,34,35,36,37,38,39,40,41,42,43,44,45,46,47,48,49,50,51,52,53,54,55,56,57,58,57,56,55,54,53,52,51,50,49,48,47,46,45,44,43,42,41,40,39,38,37,36,35,34,33,32,31,30,29,28,27,26,25,24,23,22,21,22,23,24,25,26,27,28,29,30,31,32,33,34,35,36,37,38,
40,39,38,37,36,35,34,33,32,31,30,29,28,27,26,25,24,23,22,23,24,25,26,27,28,29,30,31,32,33,34,35,36,37,38,39,40,41,42,43,44,45,46,47,48,49,50,51,52,53,54,55,56,57,58,59,58,57,56,55,54,53,52,51,50,49,48,47,46,45,44,43,42,41,40,39,38,37,36,35,34,33,32,31,30,29,28,27,26,25,24,23,22,23,24,25,26,27,28,29,30,31,32,33,34,35,36,37,38,39,
41,40,39,38,37,36,35,34,33,32,31,30,29,28,27,26,25,24,23,24,25,26,27,28,29,30,31,32,33,34,35,36,37,38,39,40,41,42,43,44,45,46,47,48,48,49,50,51,52,53,54,55,56,57,58,59,59,58,57,56,55,54,53,52,51,50,49,48,47,46,45,44,43,42,41,40,39,38,37,36,35,34,33,32,31,30,29,28,27,26,25,24,23,24,25,26,27,28,29,30,31,32,33,34,35,36,37,38,39,40,
42,41,40,39,38,37,36,35,34,33,32,31,30,29,28,27,26,25,24,25,26,27,28,29,30,31,32,33,34,35,36,37,38,39,40,41,42,43,44,45,46,47,48,48,47,48,49,50,51,52,53,54,55,56,57,58,59,59,58,57,56,55,54,53,52,51,50,49,48,47,46,45,44,43,42,41,40,39,38,37,36,35,34,33,32,31,30,29,28,27,26,25,24,25,26,27,28,29,30,31,32,33,34,35,36,37,38,39,40,41,
42,42,41,40,39,38,37,36,35,34,33,32,31,30,29,28,27,26,25,26,27,28,29,30,31,32,33,34,35,36,37,38,39,40,41,42,43,44,45,46,47,48,48,47,46,47,48,49,50,51,52,53,54,55,56,57,58,59,59,58,57,56,55,54,53,52,51,50,49,48,47,46,45,44,43,42,41,40,39,38,37,36,35,34,33,32,31,30,29,28,27,26,25,26,27,28,29,30,31,32,33,34,35,36,37,38,39,40,41,42,
41,42,42,41,40,39,38,37,36,35,34,33,32,31,30,29,28,27,26,27,28,29,30,31,32,33,34,35,36,37,38,39,40,41,42,43,44,45,46,47,48,48,47,46,45,46,47,48,49,50,51,52,53,54,55,56,57,58,59,59,58,57,56,55,54,53,52,51,50,49,48,47,46,45,44,43,42,41,40,39,38,37,36,35,34,33,32,31,30,29,28,27,26,27,28,29,30,31,32,33,34,35,36,37,38,39,40,41,42,43,
40,41,42,42,41,40,39,38,37,36,35,34,33,32,31,30,29,28,27,28,29,30,31,32,33,34,35,36,37,38,39,40,41,42,43,44,45,46,47,48,48,47,46,45,44,45,46,47,48,49,50,51,52,53,54,55,56,57,58,59,59,58,57,56,55,54,53,52,51,50,49,48,47,46,45,44,43,42,41,40,39,38,37,36,35,34,33,32,31,30,29,28,27,28,29,30,31,32,33,34,35,36,37,38,39,40,41,42,43,44,
39,40,41,42,42,41,40,39,38,37,36,35,34,33,32,31,30,29,28,29,30,31,32,33,34,35,36,37,38,39,40,41,42,43,44,45,46,47,48,48,47,46,45,44,43,44,45,46,47,48,49,50,51,52,53,54,55,56,57,58,59,59,58,57,56,55,54,53,52,51,50,49,48,47,46,45,44,43,42,41,40,39,38,37,36,35,34,33,32,31,30,29,28,29,30,31,32,33,34,35,36,37,38,39,40,41,42,43,44,45,
38,39,40,41,42,42,41,40,39,38,37,36,35,34,33,32,31,30,29,30,31,32,33,34,35,36,37,38,39,40,41,42,43,44,45,46,47,48,48,47,46,45,44,43,42,43,44,45,46,47,48,49,50,51,52,53,54,55,56,57,58,59,59,58,57,56,55,54,53,52,51,50,49,48,47,46,45,44,43,42,41,40,39,38,37,36,35,34,33,32,31,30,29,30,31,32,33,34,35,36,37,38,39,40,41,42,43,44,45,46,
37,38,39,40,41,42,42,41,40,39,38,37,36,35,34,33,32,31,30,31,32,33,34,35,36,37,38,39,40,41,42,43,44,45,46,47,48,48,47,46,45,44,43,42,41,42,43,44,45,46,47,48,49,50,51,52,53,54,55,56,57,58,59,59,58,57,56,55,54,53,52,51,50,49,48,47,46,45,44,43,42,41,40,39,38,37,36,35,34,33,32,31,30,31,32,33,34,35,36,37,38,39,40,41,42,43,44,45,46,47,
36,37,38,39,40,41,42,42,41,40,39,38,37,36,35,34,33,32,31,32,33,34,35,36,37,38,39,40,41,42,43,44,45,46,47,48,48,47,46,45,44,43,42,41,40,41,42,43,44,45,46,47,48,49,50,51,52,53,54,55,56,57,58,59,59,58,57,56,55,54,53,52,51,50,49,48,47,46,45,44,43,42,41,40,39,38,37,36,35,34,33,32,31,32,33,34,35,36,37,38,39,40,41,42,43,44,45,46,47,48,
35,36,37,38,39,40,41,42,42,41,40,39,38,37,36,35,34,33,32,33,34,35,36,37,38,39,40,41,42,43,44,45,46,47,48,48,47,46,45,44,43,42,41,40,39,40,41,42,43,44,45,46,47,48,49,50,51,52,53,54,55,56,57,58,59,59,58,57,56,55,54,53,52,51,50,49,48,47,46,45,44,43,42,41,40,39,38,37,36,35,34,33,32,33,34,35,36,37,38,39,40,41,42,43,44,45,46,47,48,49,
34,35,36,37,38,39,40,41,42,42,41,40,39,38,37,36,35,34,33,34,35,36,37,38,39,40,41,42,43,44,45,46,47,48,48,47,46,45,44,43,42,41,40,39,38,39,40,41,42,43,44,45,46,47,48,49,50,51,52,53,54,55,56,57,58,59,59,58,57,56,55,54,53,52,51,50,49,48,47,46,45,44,43,42,41,40,39,38,37,36,35,34,33,34,35,36,37,38,39,40,41,42,43,44,45,46,47,48,49,50,
33,34,35,36,37,38,39,40,41,42,42,41,40,39,38,37,36,35,34,35,36,37,38,39,40,41,42,43,44,45,46,47,48,48,47,46,45,44,43,42,41,40,39,38,37,38,39,40,41,42,43,44,45,46,47,48,49,50,51,52,53,54,55,56,57,58,59,59,58,57,56,55,54,53,52,51,50,49,48,47,46,45,44,43,42,41,40,39,38,37,36,35,34,35,36,37,38,39,40,41,42,43,44,45,46,47,48,49,50,51,
32,33,34,35,36,37,38,39,40,41,42,42,41,40,39,38,37,36,35,36,37,38,39,40,41,42,43,44,45,46,47,48,48,47,46,45,44,43,42,41,40,39,38,37,36,37,38,39,40,41,42,43,44,45,46,47,48,49,50,51,52,53,54,55,56,57,58,59,59,58,57,56,55,54,53,52,51,50,49,48,47,46,45,44,43,42,41,40,39,38,37,36,35,36,37,38,39,40,41,42,43,44,45,46,47,48,49,50,51,52,
31,32,33,34,35,36,37,38,39,40,41,42,42,41,40,39,38,37,36,37,38,39,40,41,42,43,44,45,46,47,48,48,47,46,45,44,43,42,41,40,39,38,37,36,35,36,37,38,39,40,41,42,43,44,45,46,47,48,49,50,51,52,53,54,55,56,57,58,59,59,58,57,56,55,54,53,52,51,50,49,48,47,46,45,44,43,42,41,40,39,38,37,36,37,38,39,40,41,42,43,44,45,46,47,48,49,50,51,52,53,
30,31,32,33,34,35,36,37,38,39,40,41,42,42,41,40,39,38,37,38,39,40,41,42,43,44,45,46,47,48,48,47,46,45,44,43,42,41,40,39,38,37,36,35,34,35,36,37,38,39,40,41,42,43,44,45,46,47,48,49,50,51,52,53,54,55,56,57,58,59,59,58,57,56,55,54,53,52,51,50,49,48,47,46,45,44,43,42,41,40,39,38,37,38,39,40,41,42,43,44,45,46,47,48,49,50,51,52,53,54,
29,30,31,32,33,34,35,36,37,38,39,40,41,42,42,41,40,39,38,39,40,41,42,43,44,45,46,47,48,48,47,46,45,44,43,42,41,40,39,38,37,36,35,34,33,34,35,36,37,38,39,40,41,42,43,44,45,46,47,48,49,50,51,52,53,54,55,56,57,58,59,59,58,57,56,55,54,53,52,51,50,49,48,47,46,45,44,43,42,41,40,39,38,39,40,41,42,43,44,45,46,47,48,49,50,51,52,53,54,55,
28,29,30,31,32,33,34,35,36,37,38,39,40,41,42,42,41,40,39,40,41,42,43,44,45,46,47,48,48,47,46,45,44,43,42,41,40,39,38,37,36,35,34,33,32,33,34,35,36,37,38,39,40,41,42,43,44,45,46,47,48,49,50,51,52,53,54,55,56,57,58,59,59,58,57,56,55,54,53,52,51,50,49,48,47,46,45,44,43,42,41,40,39,40,41,42,43,44,45,46,47,48,49,50,51,52,53,54,55,56,
27,28,29,30,31,32,33,34,35,36,37,38,39,40,41,42,42,41,40,41,42,43,44,45,46,47,48,48,47,46,45,44,43,42,41,40,39,38,37,36,35,34,33,32,31,32,33,34,35,36,37,38,39,40,41,42,43,44,45,46,47,48,49,50,51,52,53,54,55,56,57,58,59,59,58,57,56,55,54,53,52,51,50,49,48,47,46,45,44,43,42,41,40,41,42,43,44,45,46,47,48,49,50,51,52,53,54,55,56,57,
26,27,28,29,30,31,32,33,34,35,36,37,38,39,40,41,42,42,41,42,43,44,45,46,47,48,48,47,46,45,44,43,42,41,40,39,38,37,36,35,34,33,32,31,30,31,32,33,34,35,36,37,38,39,40,41,42,43,44,45,46,47,48,49,50,51,52,53,54,55,56,57,58,59,59,58,57,56,55,54,53,52,51,50,49,48,47,46,45,44,43,42,41,42,43,44,45,46,47,48,49,50,51,52,53,54,55,56,57,58,
25,26,27,28,29,30,31,32,33,34,35,36,37,38,39,40,41,42,42,43,44,45,46,47,48,48,47,46,45,44,43,42,41,40,39,38,37,36,35,34,33,32,31,30,29,30,31,32,33,34,35,36,37,38,39,40,41,42,43,44,45,46,47,48,49,50,51,52,53,54,55,56,57,58,59,59,58,57,56,55,54,53,52,51,50,49,48,47,46,45,44,43,42,43,44,45,46,47,48,49,50,51,52,53,54,55,56,57,58,59,
24,25,26,27,28,29,30,31,32,33,34,35,36,37,38,39,40,41,42,43,44,45,46,47,48,47,46,45,44,43,42,41,40,39,38,37,36,35,34,33,32,31,30,29,28,29,30,31,32,33,34,35,36,37,38,39,40,41,42,43,44,45,46,47,48,49,50,51,52,53,54,55,56,57,58,59,59,58,57,56,55,54,53,52,51,50,49,48,47,46,45,44,43,44,45,46,47,48,49,50,51,52,53,54,55,56,57,58,59,60,
23,24,25,26,27,28,29,30,31,32,33,34,35,36,37,38,39,40,41,42,43,44,45,46,47,46,45,44,43,42,41,40,39,38,37,36,35,34,33,32,31,30,29,28,27,28,29,30,31,32,33,34,35,36,37,38,39,40,41,42,43,44,45,46,47,48,49,50,51,52,53,54,55,56,57,58,59,59,58,57,56,55,54,53,52,51,50,49,48,47,46,45,44,45,46,47,48,49,50,51,52,53,54,55,56,57,58,59,60,61,
22,23,24,25,26,27,28,29,30,31,32,33,34,35,36,37,38,39,40,41,42,43,44,45,46,45,44,43,42,41,40,39,38,37,36,35,34,33,32,31,30,29,28,27,26,27,28,29,30,31,32,33,34,35,36,37,38,39,40,41,42,43,44,45,46,47,48,49,50,51,52,53,54,55,56,57,58,59,59,58,57,56,55,54,53,52,51,50,49,48,47,46,45,46,47,48,49,50,51,52,53,54,55,56,57,58,59,60,61,62,
21,22,23,24,25,26,27,28,29,30,31,32,33,34,35,36,37,38,39,40,41,42,43,44,45,44,43,42,41,40,39,38,37,36,35,34,33,32,31,30,29,28,27,26,25,26,27,28,29,30,31,32,33,34,35,36,37,38,39,40,41,42,43,44,45,46,47,48,49,50,51,52,53,54,55,56,57,58,59,59,58,57,56,55,54,53,52,51,50,49,48,47,46,47,48,49,50,51,52,53,54,55,56,57,58,59,60,61,62,63,
20,21,22,23,24,25,26,27,28,29,30,31,32,33,34,35,36,37,38,39,40,41,42,43,44,43,42,41,40,39,38,37,36,35,34,33,32,31,30,29,28,27,26,25,24,25,26,27,28,29,30,31,32,33,34,35,36,37,38,39,40,41,42,43,44,45,46,47,48,49,50,51,52,53,54,55,56,57,58,59,59,58,57,56,55,54,53,52,51,50,49,48,47,48,49,50,51,52,53,54,55,56,57,58,59,60,61,62,63,64,
19,20,21,22,23,24,25,26,27,28,29,30,31,32,33,34,35,36,37,38,39,40,41,42,43,42,41,40,39,38,37,36,35,34,33,32,31,30,29,28,27,26,25,24,23,24,25,26,27,28,29,30,31,32,33,34,35,36,37,38,39,40,41,42,43,44,45,46,47,48,49,50,51,52,53,54,55,56,57,58,59,59,58,57,56,55,54,53,52,51,50,49,48,49,50,51,52,53,54,55,56,57,58,59,60,61,62,63,64,65,
18,19,20,21,22,23,24,25,26,27,28,29,30,31,32,33,34,35,36,37,38,39,40,41,42,41,40,39,38,37,36,35,34,33,32,31,30,29,28,27,26,25,24,23,22,23,24,25,26,27,28,29,30,31,32,33,34,35,36,37,38,39,40,41,42,43,44,45,46,47,48,49,50,51,52,53,54,55,56,57,58,59,59,58,57,56,55,54,53,52,51,50,49,50,51,52,53,54,55,56,57,58,59,60,61,62,63,64,65,66,
17,18,19,20,21,22,23,24,25,26,27,28,29,30,31,32,33,34,35,36,37,38,39,40,41,40,39,38,37,36,35,34,33,32,31,30,29,28,27,26,25,24,23,22,21,22,23,24,25,26,27,28,29,30,31,32,33,34,35,36,37,38,39,40,41,42,43,44,45,46,47,48,49,50,51,52,53,54,55,56,57,58,59,59,58,57,56,55,54,53,52,51,50,51,52,53,54,55,56,57,58,59,60,61,62,63,64,65,66,67,
16,17,18,19,20,21,22,23,24,25,26,27,28,29,30,31,32,33,34,35,36,37,38,39,40,39,38,37,36,35,34,33,32,31,30,29,28,27,26,25,24,23,22,21,20,21,22,23,24,25,26,27,28,29,30,31,32,33,34,35,36,37,38,39,40,41,42,43,44,45,46,47,48,49,50,51,52,53,54,55,56,57,58,59,59,58,57,56,55,54,53,52,51,52,53,54,55,56,57,58,59,60,61,62,63,64,65,66,67,68,
15,16,17,18,19,20,21,22,23,24,25,26,27,28,29,30,31,32,33,34,35,36,37,38,39,38,37,36,35,34,33,32,31,30,29,28,27,26,25,24,23,22,21,20,19,20,21,22,23,24,25,26,27,28,29,30,31,32,33,34,35,36,37,38,39,40,41,42,43,44,45,46,47,48,49,50,51,52,53,54,55,56,57,58,59,59,58,57,56,55,54,53,52,53,54,55,56,57,58,59,60,61,62,63,64,65,66,67,68,69,
14,15,16,17,18,19,20,21,22,23,24,25,26,27,28,29,30,31,32,33,34,35,36,37,38,37,36,35,34,33,32,31,30,29,28,27,26,25,24,23,22,21,20,19,18,19,20,21,22,23,24,25,26,27,28,29,30,31,32,33,34,35,36,37,38,39,40,41,42,43,44,45,46,47,48,49,50,51,52,53,54,55,56,57,58,59,59,58,57,56,55,54,53,54,55,56,57,58,59,60,61,62,63,64,65,66,67,68,69,70,
13,14,15,16,17,18,19,20,21,22,23,24,25,26,27,28,29,30,31,32,33,34,35,36,37,36,35,34,33,32,31,30,29,28,27,26,25,24,23,22,21,20,19,18,17,18,19,20,21,22,23,24,25,26,27,28,29,30,31,32,33,34,35,36,37,38,39,40,41,42,43,44,45,46,47,48,49,50,51,52,53,54,55,56,57,58,59,59,58,57,56,55,54,55,56,57,58,59,60,61,62,63,64,65,66,67,68,69,70,71,
12,13,14,15,16,17,18,19,20,21,22,23,24,25,26,27,28,29,30,31,32,33,34,35,36,35,34,33,32,31,30,29,28,27,26,25,24,23,22,21,20,19,18,17,16,17,18,19,20,21,22,23,24,25,26,27,28,29,30,31,32,33,34,35,36,37,38,39,40,41,42,43,44,45,46,47,48,49,50,51,52,53,54,55,56,57,58,59,59,58,57,56,55,56,57,58,59,60,61,62,63,64,65,66,67,68,69,70,71,72,
11,12,13,14,15,16,17,18,19,20,21,22,23,24,25,26,27,28,29,30,31,32,33,34,35,34,33,32,31,30,29,28,27,26,25,24,23,22,21,20,19,18,17,16,15,16,17,18,19,20,21,22,23,24,25,26,27,28,29,30,31,32,33,34,35,36,37,38,39,40,41,42,43,44,45,46,47,48,49,50,51,52,53,54,55,56,57,58,59,59,58,57,56,57,58,59,60,61,62,63,64,65,66,67,68,69,70,71,72,73,
10,11,12,13,14,15,16,17,18,19,20,21,22,23,24,25,26,27,28,29,30,31,32,33,34,33,32,31,30,29,28,27,26,25,24,23,22,21,20,19,18,17,16,15,14,15,16,17,18,19,20,21,22,23,24,25,26,27,28,29,30,31,32,33,34,35,36,37,38,39,40,41,42,43,44,45,46,47,48,49,50,51,52,53,54,55,56,57,58,59,59,58,57,58,59,60,61,62,63,64,65,66,67,68,69,70,71,72,73,74,
9,10,11,12,13,14,15,16,17,18,19,20,21,22,23,24,25,26,27,28,29,30,31,32,33,32,31,30,29,28,27,26,25,24,23,22,21,20,19,18,17,16,15,14,13,14,15,16,17,18,19,20,21,22,23,24,25,26,27,28,29,30,31,32,33,34,35,36,37,38,39,40,41,42,43,44,45,46,47,48,49,50,51,52,53,54,55,56,57,58,59,59,58,59,60,61,62,63,64,65,66,67,68,69,70,71,72,73,74,75,
8,9,10,11,12,13,14,15,16,17,18,19,20,21,22,23,24,25,26,27,28,29,30,31,32,31,30,29,28,27,26,25,24,23,22,21,20,19,18,17,16,15,14,13,12,13,14,15,16,17,18,19,20,21,22,23,24,25,26,27,28,29,30,31,32,33,34,35,36,37,38,39,40,41,42,43,44,45,46,47,48,49,50,51,52,53,54,55,56,57,58,59,59,60,61,62,63,64,65,66,67,68,69,70,71,72,73,74,75,76,
7,8,9,10,11,12,13,14,15,16,17,18,19,20,21,22,23,24,25,26,27,28,29,30,31,30,29,28,27,26,25,24,23,22,21,20,19,18,17,16,15,14,13,12,11,12,13,14,15,16,17,18,19,20,21,22,23,24,25,26,27,28,29,30,31,32,33,34,35,36,37,38,39,40,41,42,43,44,45,46,47,48,49,50,51,52,53,54,55,56,57,58,59,60,61,62,63,64,65,66,67,68,69,70,71,72,73,74,75,76,
6,7,8,9,10,11,12,13,14,15,16,17,18,19,20,21,22,23,24,25,26,27,28,29,30,29,28,27,26,25,24,23,22,21,20,19,18,17,16,15,14,13,12,11,10,11,12,13,14,15,16,17,18,19,20,21,22,23,24,25,26,27,28,29,30,31,32,33,34,35,36,37,38,39,40,41,42,43,44,45,46,47,48,49,50,51,52,53,54,55,56,57,58,59,60,61,62,63,64,65,66,67,68,69,70,71,72,73,74,75,
5,6,7,8,9,10,11,12,13,14,15,16,17,18,19,20,21,22,23,24,25,26,27,28,29,28,27,26,25,24,23,22,21,20,19,18,17,16,15,14,13,12,11,10,9,10,11,12,13,14,15,16,17,18,19,20,21,22,23,24,25,26,27,28,29,30,31,32,33,34,35,36,37,38,39,40,41,42,43,44,45,46,47,48,49,50,51,52,53,54,55,56,57,58,59,60,61,62,63,64,65,66,67,68,69,70,71,72,73,74,
4,5,6,7,8,9,10,11,12,13,14,15,16,17,18,19,20,21,22,23,24,25,26,27,28,27,26,25,24,23,22,21,20,19,18,17,16,15,14,13,12,11,10,9,8,9,10,11,12,13,14,15,16,17,18,19,20,21,22,23,24,25,26,27,28,29,30,31,32,33,34,35,36,37,38,39,40,41,42,43,44,45,46,47,48,49,50,51,52,53,54,55,56,57,58,59,60,61,62,63,64,65,66,67,68,69,70,71,72,73,
3,4,5,6,7,8,9,10,11,12,13,14,15,16,17,18,19,20,21,22,23,24,25,26,27,26,25,24,23,22,21,20,19,18,17,16,15,14,13,12,11,10,9,8,7,8,9,10,11,12,13,14,15,16,17,18,19,20,21,22,23,24,25,26,27,28,29,30,31,32,33,34,35,36,37,38,39,40,41,42,43,44,45,46,47,48,49,50,51,52,53,54,55,56,57,58,59,60,61,62,63,64,65,66,67,68,69,70,71,72,
2,3,4,5,6,7,8,9,10,11,12,13,14,15,16,17,18,19,20,21,22,23,24,25,26,25,24,23,22,21,20,19,18,17,16,15,14,13,12,11,10,9,8,7,6,7,8,9,10,11,12,13,14,15,16,17,18,19,20,21,22,23,24,25,26,27,28,29,30,31,32,33,34,35,36,37,38,39,40,41,42,43,44,45,46,47,48,49,50,51,52,53,54,55,56,57,58,59,60,61,62,63,64,65,66,67,68,69,70,71,
1,2,3,4,5,6,7,8,9,10,11,12,13,14,15,16,17,18,19,20,21,22,23,24,25,24,23,22,21,20,19,18,17,16,15,14,13,12,11,10,9,8,7,6,5,6,7,8,9,10,11,12,13,14,15,16,17,18,19,20,21,22,23,24,25,26,27,28,29,30,31,32,33,34,35,36,37,38,39,40,41,42,43,44,45,46,47,48,49,50,51,52,53,54,55,56,57,58,59,60,61,62,63,64,65,66,67,68,69,70,
0,1,2,3,4,5,6,7,8,9,10,11,12,13,14,15,16,17,18,19,20,21,22,23,24,23,22,21,20,19,18,17,16,15,14,13,12,11,10,9,8,7,6,5,4,5,6,7,8,9,10,11,12,13,14,15,16,17,18,19,20,21,22,23,24,25,26,27,28,29,30,31,32,33,34,35,36,37,38,39,40,41,42,43,44,45,46,47,48,49,50,51,52,53,54,55,56,57,58,59,60,61,62,63,64,65,66,67,68,69,
0,1,2,3,4,5,6,7,8,9,10,11,12,13,14,15,16,17,18,19,20,21,22,23,23,22,21,20,19,18,17,16,15,14,13,12,11,10,9,8,7,6,5,4,3,4,5,6,7,8,9,10,11,12,13,14,15,16,17,18,19,20,21,22,23,24,25,26,27,28,29,30,31,32,33,34,35,36,37,38,39,40,41,42,43,44,45,46,47,48,49,50,51,52,53,54,55,56,57,58,59,60,61,62,63,64,65,66,67,68,
0,1,2,3,4,5,6,7,8,9,10,11,12,13,14,15,16,17,18,19,20,21,22,23,22,21,20,19,18,17,16,15,14,13,12,11,10,9,8,7,6,5,4,3,2,3,4,5,6,7,8,9,10,11,12,13,14,15,16,17,18,19,20,21,22,23,24,25,26,27,28,29,30,31,32,33,34,35,36,37,38,39,40,41,42,43,44,45,46,47,48,49,50,51,52,53,54,55,56,57,58,59,60,61,62,63,64,65,66,67,
0,1,2,3,4,5,6,7,8,9,10,11,12,13,14,15,16,17,18,19,20,21,22,22,21,20,19,18,17,16,15,14,13,12,11,10,9,8,7,6,5,4,3,2,1,2,3,4,5,6,7,8,9,10,11,12,13,14,15,16,17,18,19,20,21,22,23,24,25,26,27,28,29,30,31,32,33,34,35,36,37,38,39,40,41,42,43,44,45,46,47,48,49,50,51,52,53,54,55,56,57,58,59,60,61,62,63,64,65,66,
1,2,3,4,5,6,7,8,9,10,11,12,13,14,15,16,17,18,19,20,21,22,22,21,20,19,18,17,16,15,14,13,12,11,10,9,8,7,6,5,4,3,2,1,0,1,2,3,4,5,6,7,8,9,10,11,12,13,14,15,16,17,18,19,20,21,22,23,24,25,26,27,28,29,30,31,32,33,34,35,36,37,38,39,40,41,42,43,44,45,46,47,48,49,50,51,52,53,54,55,56,57,58,59,60,61,62,63,64,65,
