18,17,16,15,14,13,12,11,10,9,8,7,6,5,4,3,2,1,0,0,1,2,3,4,5,6,7,8,9,10,11,12,13,14,15,16,17,18,19,20,21,22,23,24,25,26,27,28,29,30,31,32,33,34,35,36,36,35,34,33,32,31,30,29,28,27,26,25,24,23,22,21,20,19,18,17,16,15,14,13,12,11,10,9,8,7,6,5,4,3,2,1,0,0,1,2,3,4,5,6,7,8,9,10,11,12,13,14,15,16,17,
19,18,17,16,15,14,13,12,11,10,9,8,7,6,5,4,3,2,1,1,2,3,4,5,6,7,8,9,10,11,12,13,14,15,16,17,18,19,20,21,22,23,24,25,26,27,28,29,30,31,32,33,34,35,36,37,37,36,35,34,33,32,31,30,29,28,27,26,25,24,23,22,21,20,19,18,17,16,15,14,13,12,11,10,9,8,7,6,5,4,3,2,1,1,2,3,4,5,6,7,8,9,10,11,12,13,14,15,16,17,18,
20,19,18,17,16,15,14,13,12,11,10,9,8,7,6,5,4,3,2,2,3,4,5,6,7,8,9,10,11,12,13,14,15,16,17,18,19,20,21,22,23,24,25,26,27,28,29,30,31,32,33,34,35,36,37,38,38,37,36,35,34,33,32,31,30,29,28,27,26,25,24,23,22,21,20,19,18,17,16,15,14,13,12,11,10,9,8,7,6,5,4,3,2,2,3,4,5,6,7,8,9,10,11,12,13,14,15,16,17,18,19,
21,20,19,18,17,16,15,14,13,12,11,10,9,8,7,6,5,4,3,3,4,5,6,7,8,9,10,11,12,13,14,15,16,17,18,19,20,21,22,23,24,25,26,27,28,29,30,31,32,33,34,35,36,37,38,39,39,38,37,36,35,34,33,32,31,30,29,28,27,26,25,24,23,22,21,20,19,18,17,16,15,14,13,12,11,10,9,8,7,6,5,4,3,3,4,5,6,7,8,9,10,11,12,13,14,15,16,17,18,19,20,
22,21,20,19,18,17,16,15,14,13,12,11,10,9,8,7,6,5,4,4,5,6,7,8,9,10,11,12,13,14,15,16,17,18,19,20,21,22,23,24,25,26,27,28,29,30,31,32,33,34,35,36,37,38,39,40,40,39,38,37,36,35,34,33,32,31,30,29,28,27,26,25,24,23,22,21,20,19,18,17,16,15,14,13,12,11,10,9,8,7,6,5,4,4,5,6,7,8,9,10,11,12,13,14,15,16,17,18,19,20,21,
23,22,21,20,19,18,17,16,15,14,13,12,11,10,9,8,7,6,5,5,6,7,8,9,10,11,12,13,14,15,16,17,18,19,20,21,22,23,24,25,26,27,28,29,30,31,32,33,34,35,36,37,38,39,40,41,41,40,39,38,37,36,35,34,33,32,31,30,29,28,27,26,25,24,23,22,21,20,19,18,17,16,15,14,13,12,11,10,9,8,7,6,5,5,6,7,8,9,10,11,12,13,14,15,16,17,18,19,20,21,22,
24,23,22,21,20,19,18,17,16,15,14,13,12,11,10,9,8,7,6,6,7,8,9,10,11,12,13,14,15,16,17,18,19,20,21,22,23,24,25,26,27,28,29,30,31,32,33,34,35,36,37,38,39,40,41,42,42,41,40,39,38,37,36,35,34,33,32,31,30,29,28,27,26,25,24,23,22,21,20,19,18,17,16,15,14,13,12,11,10,9,8,7,6,6,7,8,9,10,11,12,13,14,15,16,17,18,19,20,21,22,23,
25,24,23,22,21,20,19,18,17,16,15,14,13,12,11,10,9,8,7,7,8,9,10,11,12,13,14,15,16,17,18,19,20,21,22,23,24,25,26,27,28,29,30,31,32,33,34,35,36,37,38,39,40,41,42,43,43,42,41,40,39,38,37,36,35,34,33,32,31,30,29,28,27,26,25,24,23,22,21,20,19,18,17,16,15,14,13,12,11,10,9,8,7,7,8,9,10,11,12,13,14,15,16,17,18,19,20,21,22,23,24,
26,25,24,23,22,21,20,19,18,17,16,15,14,13,12,11,10,9,8,8,9,10,11,12,13,14,15,16,17,18,19,20,21,22,23,24,25,26,27,28,29,30,31,32,33,34,35,36,37,38,39,40,41,42,43,44,44,43,42,41,40,39,38,37,36,35,34,33,32,31,30,29,28,27,26,25,24,23,22,21,20,19,18,17,16,15,14,13,12,11,10,9,8,8,9,10,11,12,13,14,15,16,17,18,19,20,21,22,23,24,25,
27,26,25,24,23,22,21,20,19,18,17,16,15,14,13,12,11,10,9,9,10,11,12,13,14,15,16,17,18,19,20,21,22,23,24,25,26,27,28,29,30,31,32,33,34,35,36,37,38,39,40,41,42,43,44,45,45,44,43,42,41,40,39,38,37,36,35,34,33,32,31,30,29,28,27,26,25,24,23,22,21,20,19,18,17,16,15,14,13,12,11,10,9,9,10,11,12,13,14,15,16,17,18,19,20,21,22,23,24,25,26,
28,27,26,25,24,23,22,21,20,19,18,17,16,15,14,13,12,11,10,10,11,12,13,14,15,16,17,18,19,20,21,22,23,24,25,26,27,28,29,30,31,32,33,34,35,36,37,38,39,40,41,42,43,44,45,46,46,45,44,43,42,41,40,39,38,37,36,35,34,33,32,31,30,29,28,27,26,25,24,23,22,21,20,19,18,17,16,15,14,13,12,11,10,10,11,12,13,14,15,16,17,18,19,20,21,22,23,24,25,26,27,
29,28,27,26,25,24,23,22,21,20,19,18,17,16,15,14,13,12,11,11,12,13,14,15,16,17,18,19,20,21,22,23,24,25,26,27,28,29,30,31,32,33,34,35,36,37,38,39,40,41,42,43,44,45,46,47,47,46,45,44,43,42,41,40,39,38,37,36,35,34,33,32,31,30,29,28,27,26,25,24,23,22,21,20,19,18,17,16,15,14,13,12,11,11,12,13,14,15,16,17,18,19,20,21,22,23,24,25,26,27,28,
30,29,28,27,26,25,24,23,22,21,20,19,18,17,16,15,14,13,12,12,13,14,15,16,17,18,19,20,21,22,23,24,25,26,27,28,29,30,31,32,33,34,35,36,37,38,39,40,41,42,43,44,45,46,47,48,48,47,46,45,44,43,42,41,40,39,38,37,36,35,34,33,32,31,30,29,28,27,26,25,24,23,22,21,20,19,18,17,16,15,14,13,12,12,13,14,15,16,17,18,19,20,21,22,23,24,25,26,27,28,29,
31,30,29,28,27,26,25,24,23,22,21,20,19,18,17,16,15,14,13,13,14,15,16,17,18,19,20,21,22,23,24,25,26,27,28,29,30,31,32,33,34,35,36,37,38,39,40,41,42,43,44,45,46,47,48,49,49,48,47,46,45,44,43,42,41,40,39,38,37,36,35,34,33,32,31,30,29,28,27,26,25,24,23,22,21,20,19,18,17,16,15,14,13,13,14,15,16,17,18,19,20,21,22,23,24,25,26,27,28,29,30,
32,31,30,29,28,27,26,25,24,23,22,21,20,19,18,17,16,15,14,14,15,16,17,18,19,20,21,22,23,24,25,26,27,28,29,30,31,32,33,34,35,36,37,38,39,40,41,42,43,44,45,46,47,48,49,50,50,49,48,47,46,45,44,43,42,41,40,39,38,37,36,35,34,33,32,31,30,29,28,27,26,25,24,23,22,21,20,19,18,17,16,15,14,14,15,16,17,18,19,20,21,22,23,24,25,26,27,28,29,30,31,
33,32,31,30,29,28,27,26,25,24,23,22,21,20,19,18,17,16,15,15,16,17,18,19,20,21,22,23,24,25,26,27,28,29,30,31,32,33,34,35,36,37,38,39,40,41,42,43,44,45,46,47,48,49,50,51,51,50,49,48,47,46,45,44,43,42,41,40,39,38,37,36,35,34,33,32,31,30,29,28,27,26,25,24,23,22,21,20,19,18,17,16,15,15,16,17,18,19,20,21,22,23,24,25,26,27,28,29,30,31,32,
34,33,32,31,30,29,28,27,26,25,24,23,22,21,20,19,18,17,16,16,17,18,19,20,21,22,23,24,25,26,27,28,29,30,31,32,33,34,35,36,37,38,39,40,41,42,43,44,45,46,47,48,49,50,51,52,52,51,50,49,48,47,46,45,44,43,42,41,40,39,38,37,36,35,34,33,32,31,30,29,28,27,26,25,24,23,22,21,20,19,18,17,16,16,17,18,19,20,21,22,23,24,25,26,27,28,29,30,31,32,33,
35,34,33,32,31,30,29,28,27,26,25,24,23,22,21,20,19,18,17,17,18,19,20,21,22,23,24,25,26,27,28,29,30,31,32,33,34,35,36,37,38,39,40,41,42,43,44,45,46,47,48,49,50,51,52,53,53,52,51,50,49,48,47,46,45,44,43,42,41,40,39,38,37,36,35,34,33,32,31,30,29,28,27,26,25,24,23,22,21,20,19,18,17,17,18,19,20,21,22,23,24,25,26,27,28,29,30,31,32,33,34,
36,35,34,33,32,31,30,29,28,27,26,25,24,23,22,21,20,19,18,18,19,20,21,22,23,24,25,26,27,28,29,30,31,32,33,34,35,36,37,38,39,40,41,42,43,44,45,46,47,48,49,50,51,52,53,54,54,53,52,51,50,49,48,47,46,45,44,43,42,41,40,39,38,37,36,35,34,33,32,31,30,29,28,27,26,25,24,23,22,21,20,19,18,18,19,20,21,22,23,24,25,26,27,28,29,30,31,32,33,34,35,
37,36,35,34,33,32,31,30,29,28,27,26,25,24,23,22,21,20,19,19,20,21,22,23,24,25,26,27,28,29,30,31,32,33,34,35,36,37,38,39,40,41,42,43,44,45,46,47,48,49,50,51,52,53,54,55,55,54,53,52,51,50,49,48,47,46,45,44,43,42,41,40,39,38,37,36,35,34,33,32,31,30,29,28,27,26,25,24,23,22,21,20,19,19,20,21,22,23,24,25,26,27,28,29,30,31,32,33,34,35,36,
38,37,36,35,34,33,32,31,30,29,28,27,26,25,24,23,22,21,20,20,21,22,23,24,25,26,27,28,29,30,31,32,33,34,35,36,37,38,39,40,41,42,43,44,45,46,47,48,49,50,51,52,53,54,55,56,56,55,54,53,52,51,50,49,48,47,46,45,44,43,42,41,40,39,38,37,36,35,34,33,32,31,30,29,28,27,26,25,24,23,22,21,20,20,21,22,23,24,25,26,27,28,29,30,31,32,33,34,35,36,37,
39,38,37,36,35,34,33,32,31,30,29,28,27,26,25,24,23,22,21,21,22,23,24,25,26,27,28,29,30,31,32,33,34,35,36,37,38,39,40,41,42,43,44,45,46,47,48,49,50,51,52,53,54,55,56,57,57,56,55,54,53,52,51,50,49,48,47,46,45,44,43,42,41,40,39,38,37,36,35,34,33,32,31,30,29,28,27,26,25,24,23,22,21,21,22,23,24,25,26,27,28,29,30,31,32,33,34,35,36,37,38,
40,39,38,37,36,35,34,33,32,31,30,29,28,27,26,25,24,23,22,22,23,24,25,26,27,28,29,30,31,32,33,34,35,36,37,38,39,40,41,42,43,44,45,46,47,48,49,50,51,52,53,54,55,56,57,58,58,57,56,55,54,53,52,51,50,49,48,47,46,45,44,43,42,41,40,39,38,37,36,35,34,33,32,31,30,29,28,27,26,25,24,23,22,22,23,24,25,26,27,28,29,30,31,32,33,34,35,36,37,38,39,
41,40,39,38,37,36,35,34,33,32,31,30,29,28,27,26,25,24,23,23,24,25,26,27,28,29,30,31,32,33,34,35,36,37,38,39,40,41,42,43,44,45,46,47,48,49,50,51,52,53,54,55,56,57,58,59,59,58,57,56,55,54,53,52,51,50,49,48,47,46,45,44,43,42,41,40,39,38,37,36,35,34,33,32,31,30,29,28,27,26,25,24,23,23,24,25,26,27,28,29,30,31,32,33,34,35,36,37,38,39,40,
42,41,40,39,38,37,36,35,34,33,32,31,30,29,28,27,26,25,24,24,25,26,27,28,29,30,31,32,33,34,35,36,37,38,39,40,41,42,43,44,45,46,47,48,48,48,49,50,51,52,53,54,55,56,57,58,59,59,58,57,56,55,54,53,52,51,50,49,48,47,46,45,44,43,42,41,40,39,38,37,36,35,34,33,32,31,30,29,28,27,26,25,24,24,25,26,27,28,29,30,31,32,33,34,35,36,37,38,39,40,41,
42,42,41,40,39,38,37,36,35,34,33,32,31,30,29,28,27,26,25,25,26,27,28,29,30,31,32,33,34,35,36,37,38,39,40,41,42,43,44,45,46,47,48,48,47,47,48,49,50,51,52,53,54,55,56,57,58,59,59,58,57,56,55,54,53,52,51,50,49,48,47,46,45,44,43,42,41,40,39,38,37,36,35,34,33,32,31,30,29,28,27,26,25,25,26,27,28,29,30,31,32,33,34,35,36,37,38,39,40,41,42,
41,42,42,41,40,39,38,37,36,35,34,33,32,31,30,29,28,27,26,26,27,28,29,30,31,32,33,34,35,36,37,38,39,40,41,42,43,44,45,46,47,48,48,47,46,46,47,48,49,50,51,52,53,54,55,56,57,58,59,59,58,57,56,55,54,53,52,51,50,49,48,47,46,45,44,43,42,41,40,39,38,37,36,35,34,33,32,31,30,29,28,27,26,26,27,28,29,30,31,32,33,34,35,36,37,38,39,40,41,42,43,
40,41,42,42,41,40,39,38,37,36,35,34,33,32,31,30,29,28,27,27,28,29,30,31,32,33,34,35,36,37,38,39,40,41,42,43,44,45,46,47,48,48,47,46,45,45,46,47,48,49,50,51,52,53,54,55,56,57,58,59,59,58,57,56,55,54,53,52,51,50,49,48,47,46,45,44,43,42,41,40,39,38,37,36,35,34,33,32,31,30,29,28,27,27,28,29,30,31,32,33,34,35,36,37,38,39,40,41,42,43,44,
39,40,41,42,42,41,40,39,38,37,36,35,34,33,32,31,30,29,28,28,29,30,31,32,33,34,35,36,37,38,39,40,41,42,43,44,45,46,47,48,48,47,46,45,44,44,45,46,47,48,49,50,51,52,53,54,55,56,57,58,59,59,58,57,56,55,54,53,52,51,50,49,48,47,46,45,44,43,42,41,40,39,38,37,36,35,34,33,32,31,30,29,28,28,29,30,31,32,33,34,35,36,37,38,39,40,41,42,43,44,45,
38,39,40,41,42,42,41,40,39,38,37,36,35,34,33,32,31,30,29,29,30,31,32,33,34,35,36,37,38,39,40,41,42,43,44,45,46,47,48,48,47,46,45,44,43,43,44,45,46,47,48,49,50,51,52,53,54,55,56,57,58,59,59,58,57,56,55,54,53,52,51,50,49,48,47,46,45,44,43,42,41,40,39,38,37,36,35,34,33,32,31,30,29,29,30,31,32,33,34,35,36,37,38,39,40,41,42,43,44,45,46,
37,38,39,40,41,42,42,41,40,39,38,37,36,35,34,33,32,31,30,30,31,32,33,34,35,36,37,38,39,40,41,42,43,44,45,46,47,48,48,47,46,45,44,43,42,42,43,44,45,46,47,48,49,50,51,52,53,54,55,56,57,58,59,59,58,57,56,55,54,53,52,51,50,49,48,47,46,45,44,43,42,41,40,39,38,37,36,35,34,33,32,31,30,30,31,32,33,34,35,36,37,38,39,40,41,42,43,44,45,46,47,
36,37,38,39,40,41,42,42,41,40,39,38,37,36,35,34,33,32,31,31,32,33,34,35,36,37,38,39,40,41,42,43,44,45,46,47,48,48,47,46,45,44,43,42,41,41,42,43,44,45,46,47,48,49,50,51,52,53,54,55,56,57,58,59,59,58,57,56,55,54,53,52,51,50,49,48,47,46,45,44,43,42,41,40,39,38,37,36,35,34,33,32,31,31,32,33,34,35,36,37,38,39,40,41,42,43,44,45,46,47,48,
35,36,37,38,39,40,41,42,42,41,40,39,38,37,36,35,34,33,32,32,33,34,35,36,37,38,39,40,41,42,43,44,45,46,47,48,48,47,46,45,44,43,42,41,40,40,41,42,43,44,45,46,47,48,49,50,51,52,53,54,55,56,57,58,59,59,58,57,56,55,54,53,52,51,50,49,48,47,46,45,44,43,42,41,40,39,38,37,36,35,34,33,32,32,33,34,35,36,37,38,39,40,41,42,43,44,45,46,47,48,49,
34,35,36,37,38,39,40,41,42,42,41,40,39,38,37,36,35,34,33,33,34,35,36,37,38,39,40,41,42,43,44,45,46,47,48,48,47,46,45,44,43,42,41,40,39,39,40,41,42,43,44,45,46,47,48,49,50,51,52,53,54,55,56,57,58,59,59,58,57,56,55,54,53,52,51,50,49,48,47,46,45,44,43,42,41,40,39,38,37,36,35,34,33,33,34,35,36,37,38,39,40,41,42,43,44,45,46,47,48,49,50,
33,34,35,36,37,38,39,40,41,42,42,41,40,39,38,37,36,35,34,34,35,36,37,38,39,40,41,42,43,44,45,46,47,48,48,47,46,45,44,43,42,41,40,39,38,38,39,40,41,42,43,44,45,46,47,48,49,50,51,52,53,54,55,56,57,58,59,59,58,57,56,55,54,53,52,51,50,49,48,47,46,45,44,43,42,41,40,39,38,37,36,35,34,34,35,36,37,38,39,40,41,42,43,44,45,46,47,48,49,50,51,
32,33,34,35,36,37,38,39,40,41,42,42,41,40,39,38,37,36,35,35,36,37,38,39,40,41,42,43,44,45,46,47,48,48,47,46,45,44,43,42,41,40,39,38,37,37,38,39,40,41,42,43,44,45,46,47,48,49,50,51,52,53,54,55,56,57,58,59,59,58,57,56,55,54,53,52,51,50,49,48,47,46,45,44,43,42,41,40,39,38,37,36,35,35,36,37,38,39,40,41,42,43,44,45,46,47,48,49,50,51,52,
31,32,33,34,35,36,37,38,39,40,41,42,42,41,40,39,38,37,36,36,37,38,39,40,41,42,43,44,45,46,47,48,48,47,46,45,44,43,42,41,40,39,38,37,36,36,37,38,39,40,41,42,43,44,45,46,47,48,49,50,51,52,53,54,55,56,57,58,59,59,58,57,56,55,54,53,52,51,50,49,48,47,46,45,44,43,42,41,40,39,38,37,36,36,37,38,39,40,41,42,43,44,45,46,47,48,49,50,51,52,53,
30,31,32,33,34,35,36,37,38,39,40,41,42,42,41,40,39,38,37,37,38,39,40,41,42,43,44,45,46,47,48,48,47,46,45,44,43,42,41,40,39,38,37,36,35,35,36,37,38,39,40,41,42,43,44,45,46,47,48,49,50,51,52,53,54,55,56,57,58,59,59,58,57,56,55,54,53,52,51,50,49,48,47,46,45,44,43,42,41,40,39,38,37,37,38,39,40,41,42,43,44,45,46,47,48,49,50,51,52,53,54,
29,30,31,32,33,34,35,36,37,38,39,40,41,42,42,41,40,39,38,38,39,40,41,42,43,44,45,46,47,48,48,47,46,45,44,43,42,41,40,39,38,37,36,35,34,34,35,36,37,38,39,40,41,42,43,44,45,46,47,48,49,50,51,52,53,54,55,56,57,58,59,59,58,57,56,55,54,53,52,51,50,49,48,47,46,45,44,43,42,41,40,39,38,38,39,40,41,42,43,44,45,46,47,48,49,50,51,52,53,54,55,
28,29,30,31,32,33,34,35,36,37,38,39,40,41,42,42,41,40,39,39,40,41,42,43,44,45,46,47,48,48,47,46,45,44,43,42,41,40,39,38,37,36,35,34,33,33,34,35,36,37,38,39,40,41,42,43,44,45,46,47,48,49,50,51,52,53,54,55,56,57,58,59,59,58,57,56,55,54,53,52,51,50,49,48,47,46,45,44,43,42,41,40,39,39,40,41,42,43,44,45,46,47,48,49,50,51,52,53,54,55,56,
27,28,29,30,31,32,33,34,35,36,37,38,39,40,41,42,42,41,40,40,41,42,43,44,45,46,47,48,48,47,46,45,44,43,42,41,40,39,38,37,36,35,34,33,32,32,33,34,35,36,37,38,39,40,41,42,43,44,45,46,47,48,49,50,51,52,53,54,55,56,57,58,59,59,58,57,56,55,54,53,52,51,50,49,48,47,46,45,44,43,42,41,40,40,41,42,43,44,45,46,47,48,49,50,51,52,53,54,55,56,57,
26,27,28,29,30,31,32,33,34,35,36,37,38,39,40,41,42,42,41,41,42,43,44,45,46,47,48,48,47,46,45,44,43,42,41,40,39,38,37,36,35,34,33,32,31,31,32,33,34,35,36,37,38,39,40,41,42,43,44,45,46,47,48,49,50,51,52,53,54,55,56,57,58,59,59,58,57,56,55,54,53,52,51,50,49,48,47,46,45,44,43,42,41,41,42,43,44,45,46,47,48,49,50,51,52,53,54,55,56,57,58,
25,26,27,28,29,30,31,32,33,34,35,36,37,38,39,40,41,42,42,42,43,44,45,46,47,48,48,47,46,45,44,43,42,41,40,39,38,37,36,35,34,33,32,31,30,30,31,32,33,34,35,36,37,38,39,40,41,42,43,44,45,46,47,48,49,50,51,52,53,54,55,56,57,58,59,59,58,57,56,55,54,53,52,51,50,49,48,47,46,45,44,43,42,42,43,44,45,46,47,48,49,50,51,52,53,54,55,56,57,58,59,
24,25,26,27,28,29,30,31,32,33,34,35,36,37,38,39,40,41,42,43,44,45,46,47,48,48,47,46,45,44,43,42,41,40,39,38,37,36,35,34,33,32,31,30,29,29,30,31,32,33,34,35,36,37,38,39,40,41,42,43,44,45,46,47,48,49,50,51,52,53,54,55,56,57,58,59,59,58,57,56,55,54,53,52,51,50,49,48,47,46,45,44,43,43,44,45,46,47,48,49,50,51,52,53,54,55,56,57,58,59,60,
23,24,25,26,27,28,29,30,31,32,33,34,35,36,37,38,39,40,41,42,43,44,45,46,47,47,46,45,44,43,42,41,40,39,38,37,36,35,34,33,32,31,30,29,28,28,29,30,31,32,33,34,35,36,37,38,39,40,41,42,43,44,45,46,47,48,49,50,51,52,53,54,55,56,57,58,59,59,58,57,56,55,54,53,52,51,50,49,48,47,46,45,44,44,45,46,47,48,49,50,51,52,53,54,55,56,57,58,59,60,61,
22,23,24,25,26,27,28,29,30,31,32,33,34,35,36,37,38,39,40,41,42,43,44,45,46,46,45,44,43,42,41,40,39,38,37,36,35,34,33,32,31,30,29,28,27,27,28,29,30,31,32,33,34,35,36,37,38,39,40,41,42,43,44,45,46,47,48,49,50,51,52,53,54,55,56,57,58,59,59,58,57,56,55,54,53,52,51,50,49,48,47,46,45,45,46,47,48,49,50,51,52,53,54,55,56,57,58,59,60,61,62,
21,22,23,24,25,26,27,28,29,30,31,32,33,34,35,36,37,38,39,40,41,42,43,44,45,45,44,43,42,41,40,39,38,37,36,35,34,33,32,31,30,29,28,27,26,26,27,28,29,30,31,32,33,34,35,36,37,38,39,40,41,42,43,44,45,46,47,48,49,50,51,52,53,54,55,56,57,58,59,59,58,57,56,55,54,53,52,51,50,49,48,47,46,46,47,48,49,50,51,52,53,54,55,56,57,58,59,60,61,62,63,
20,21,22,23,24,25,26,27,28,29,30,31,32,33,34,35,36,37,38,39,40,41,42,43,44,44,43,42,41,40,39,38,37,36,35,34,33,32,31,30,29,28,27,26,25,25,26,27,28,29,30,31,32,33,34,35,36,37,38,39,40,41,42,43,44,45,46,47,48,49,50,51,52,53,54,55,56,57,58,59,59,58,57,56,55,54,53,52,51,50,49,48,47,47,48,49,50,51,52,53,54,55,56,57,58,59,60,61,62,63,64,
19,20,21,22,23,24,25,26,27,28,29,30,31,32,33,34,35,36,37,38,39,40,41,42,43,43,42,41,40,39,38,37,36,35,34,33,32,31,30,29,28,27,26,25,24,24,25,26,27,28,29,30,31,32,33,34,35,36,37,38,39,40,41,42,43,44,45,46,47,48,49,50,51,52,53,54,55,56,57,58,59,59,58,57,56,55,54,53,52,51,50,49,48,48,49,50,51,52,53,54,55,56,57,58,59,60,61,62,63,64,65,
18,19,20,21,22,23,24,25,26,27,28,29,30,31,32,33,34,35,36,37,38,39,40,41,42,42,41,40,39,38,37,36,35,34,33,32,31,30,29,28,27,26,25,24,23,23,24,25,26,27,28,29,30,31,32,33,34,35,36,37,38,39,40,41,42,43,44,45,46,47,48,49,50,51,52,53,54,55,56,57,58,59,59,58,57,56,55,54,53,52,51,50,49,49,50,51,52,53,54,55,56,57,58,59,60,61,62,63,64,65,66,
17,18,19,20,21,22,23,24,25,26,27,28,29,30,31,32,33,34,35,36,37,38,39,40,41,41,40,39,38,37,36,35,34,33,32,31,30,29,28,27,26,25,24,23,22,22,23,24,25,26,27,28,29,30,31,32,33,34,35,36,37,38,39,40,41,42,43,44,45,46,47,48,49,50,51,52,53,54,55,56,57,58,59,59,58,57,56,55,54,53,52,51,50,50,51,52,53,54,55,56,57,58,59,60,61,62,63,64,65,66,67,
16,17,18,19,20,21,22,23,24,25,26,27,28,29,30,31,32,33,34,35,36,37,38,39,40,40,39,38,37,36,35,34,33,32,31,30,29,28,27,26,25,24,23,22,21,21,22,23,24,25,26,27,28,29,30,31,32,33,34,35,36,37,38,39,40,41,42,43,44,45,46,47,48,49,50,51,52,53,54,55,56,57,58,59,59,58,57,56,55,54,53,52,51,51,52,53,54,55,56,57,58,59,60,61,62,63,64,65,66,67,68,
15,16,17,18,19,20,21,22,23,24,25,26,27,28,29,30,31,32,33,34,35,36,37,38,39,39,38,37,36,35,34,33,32,31,30,29,28,27,26,25,24,23,22,21,20,20,21,22,23,24,25,26,27,28,29,30,31,32,33,34,35,36,37,38,39,40,41,42,43,44,45,46,47,48,49,50,51,52,53,54,55,56,57,58,59,59,58,57,56,55,54,53,52,52,53,54,55,56,57,58,59,60,61,62,63,64,65,66,67,68,69,
14,15,16,17,18,19,20,21,22,23,24,25,26,27,28,29,30,31,32,33,34,35,36,37,38,38,37,36,35,34,33,32,31,30,29,28,27,26,25,24,23,22,21,20,19,19,20,21,22,23,24,25,26,27,28,29,30,31,32,33,34,35,36,37,38,39,40,41,42,43,44,45,46,47,48,49,50,51,52,53,54,55,56,57,58,59,59,58,57,56,55,54,53,53,54,55,56,57,58,59,60,61,62,63,64,65,66,67,68,69,70,
13,14,15,16,17,18,19,20,21,22,23,24,25,26,27,28,29,30,31,32,33,34,35,36,37,37,36,35,34,33,32,31,30,29,28,27,26,25,24,23,22,21,20,19,18,18,19,20,21,22,23,24,25,26,27,28,29,30,31,32,33,34,35,36,37,38,39,40,41,42,43,44,45,46,47,48,49,50,51,52,53,54,55,56,57,58,59,59,58,57,56,55,54,54,55,56,57,58,59,60,61,62,63,64,65,66,67,68,69,70,71,
12,13,14,15,16,17,18,19,20,21,22,23,24,25,26,27,28,29,30,31,32,33,34,35,36,36,35,34,33,32,31,30,29,28,27,26,25,24,23,22,21,20,19,18,17,17,18,19,20,21,22,23,24,25,26,27,28,29,30,31,32,33,34,35,36,37,38,39,40,41,42,43,44,45,46,47,48,49,50,51,52,53,54,55,56,57,58,59,59,58,57,56,55,55,56,57,58,59,60,61,62,63,64,65,66,67,68,69,70,71,72,
11,12,13,14,15,16,17,18,19,20,21,22,23,24,25,26,27,28,29,30,31,32,33,34,35,35,34,33,32,31,30,29,28,27,26,25,24,23,22,21,20,19,18,17,16,16,17,18,19,20,21,22,23,24,25,26,27,28,29,30,31,32,33,34,35,36,37,38,39,40,41,42,43,44,45,46,47,48,49,50,51,52,53,54,55,56,57,58,59,59,58,57,56,56,57,58,59,60,61,62,63,64,65,66,67,68,69,70,71,72,73,
10,11,12,13,14,15,16,17,18,19,20,21,22,23,24,25,26,27,28,29,30,31,32,33,34,34,33,32,31,30,29,28,27,26,25,24,23,22,21,20,19,18,17,16,15,15,16,17,18,19,20,21,22,23,24,25,26,27,28,29,30,31,32,33,34,35,36,37,38,39,40,41,42,43,44,45,46,47,48,49,50,51,52,53,54,55,56,57,58,59,59,58,57,57,58,59,60,61,62,63,64,65,66,67,68,69,70,71,72,73,74,
9,10,11,12,13,14,15,16,17,18,19,20,21,22,23,24,25,26,27,28,29,30,31,32,33,33,32,31,30,29,28,27,26,25,24,23,22,21,20,19,18,17,16,15,14,14,15,16,17,18,19,20,21,22,23,24,25,26,27,28,29,30,31,32,33,34,35,36,37,38,39,40,41,42,43,44,45,46,47,48,49,50,51,52,53,54,55,56,57,58,59,59,58,58,59,60,61,62,63,64,65,66,67,68,69,70,71,72,73,74,75,
8,9,10,11,12,13,14,15,16,17,18,19,20,21,22,23,24,25,26,27,28,29,30,31,32,32,31,30,29,28,27,26,25,24,23,22,21,20,19,18,17,16,15,14,13,13,14,15,16,17,18,19,20,21,22,23,24,25,26,27,28,29,30,31,32,33,34,35,36,37,38,39,40,41,42,43,44,45,46,47,48,49,50,51,52,53,54,55,56,57,58,59,59,59,60,61,62,63,64,65,66,67,68,69,70,71,72,73,74,75,76,
7,8,9,10,11,12,13,14,15,16,17,18,19,20,21,22,23,24,25,26,27,28,29,30,31,31,30,29,28,27,26,25,24,23,22,21,20,19,18,17,16,15,14,13,12,12,13,14,15,16,17,18,19,20,21,22,23,24,25,26,27,28,29,30,31,32,33,34,35,36,37,38,39,40,41,42,43,44,45,46,47,48,49,50,51,52,53,54,55,56,57,58,59,60,61,62,63,64,65,66,67,68,69,70,71,72,73,74,75,76,77,
6,7,8,9,10,11,12,13,14,15,16,17,18,19,20,21,22,23,24,25,26,27,28,29,30,30,29,28,27,26,25,24,23,22,21,20,19,18,17,16,15,14,13,12,11,11,12,13,14,15,16,17,18,19,20,21,22,23,24,25,26,27,28,29,30,31,32,33,34,35,36,37,38,39,40,41,42,43,44,45,46,47,48,49,50,51,52,53,54,55,56,57,58,59,60,61,62,63,64,65,66,67,68,69,70,71,72,73,74,75,76,
5,6,7,8,9,10,11,12,13,14,15,16,17,18,19,20,21,22,23,24,25,26,27,28,29,29,28,27,26,25,24,23,22,21,20,19,18,17,16,15,14,13,12,11,10,10,11,12,13,14,15,16,17,18,19,20,21,22,23,24,25,26,27,28,29,30,31,32,33,34,35,36,37,38,39,40,41,42,43,44,45,46,47,48,49,50,51,52,53,54,55,56,57,58,59,60,61,62,63,64,65,66,67,68,69,70,71,72,73,74,75,
4,5,6,7,8,9,10,11,12,13,14,15,16,17,18,19,20,21,22,23,24,25,26,27,28,28,27,26,25,24,23,22,21,20,19,18,17,16,15,14,13,12,11,10,9,9,10,11,12,13,14,15,16,17,18,19,20,21,22,23,24,25,26,27,28,29,30,31,32,33,34,35,36,37,38,39,40,41,42,43,44,45,46,47,48,49,50,51,52,53,54,55,56,57,58,59,60,61,62,63,64,65,66,67,68,69,70,71,72,73,74,
3,4,5,6,7,8,9,10,11,12,13,14,15,16,17,18,19,20,21,22,23,24,25,26,27,27,26,25,24,23,22,21,20,19,18,17,16,15,14,13,12,11,10,9,8,8,9,10,11,12,13,14,15,16,17,18,19,20,21,22,23,24,25,26,27,28,29,30,31,32,33,34,35,36,37,38,39,40,41,42,43,44,45,46,47,48,49,50,51,52,53,54,55,56,57,58,59,60,61,62,63,64,65,66,67,68,69,70,71,72,73,
2,3,4,5,6,7,8,9,10,11,12,13,14,15,16,17,18,19,20,21,22,23,24,25,26,26,25,24,23,22,21,20,19,18,17,16,15,14,13,12,11,10,9,8,7,7,8,9,10,11,12,13,14,15,16,17,18,19,20,21,22,23,24,25,26,27,28,29,30,31,32,33,34,35,36,37,38,39,40,41,42,43,44,45,46,47,48,49,50,51,52,53,54,55,56,57,58,59,60,61,62,63,64,65,66,67,68,69,70,71,72,
1,2,3,4,5,6,7,8,9,10,11,12,13,14,15,16,17,18,19,20,21,22,23,24,25,25,24,23,22,21,20,19,18,17,16,15,14,13,12,11,10,9,8,7,6,6,7,8,9,10,11,12,13,14,15,16,17,18,19,20,21,22,23,24,25,26,27,28,29,30,31,32,33,34,35,36,37,38,39,40,41,42,43,44,45,46,47,48,49,50,51,52,53,54,55,56,57,58,59,60,61,62,63,64,65,66,67,68,69,70,71,
0,1,2,3,4,5,6,7,8,9,10,11,12,13,14,15,16,17,18,19,20,21,22,23,24,24,23,22,21,20,19,18,17,16,15,14,13,12,11,10,9,8,7,6,5,5,6,7,8,9,10,11,12,13,14,15,16,17,18,19,20,21,22,23,24,25,26,27,28,29,30,31,32,33,34,35,36,37,38,39,40,41,42,43,44,45,46,47,48,49,50,51,52,53,54,55,56,57,58,59,60,61,62,63,64,65,66,67,68,69,70,
0,1,2,3,4,5,6,7,8,9,10,11,12,13,14,15,16,17,18,19,20,21,22,23,24,23,22,21,20,19,18,17,16,15,14,13,12,11,10,9,8,7,6,5,4,4,5,6,7,8,9,10,11,12,13,14,15,16,17,18,19,20,21,22,23,24,25,26,27,28,29,30,31,32,33,34,35,36,37,38,39,40,41,42,43,44,45,46,47,48,49,50,51,52,53,54,55,56,57,58,59,60,61,62,63,64,65,66,67,68,69,
0,1,2,3,4,5,6,7,8,9,10,11,12,13,14,15,16,17,18,19,20,21,22,23,23,22,21,20,19,18,17,16,15,14,13,12,11,10,9,8,7,6,5,4,3,3,4,5,6,7,8,9,10,11,12,13,14,15,16,17,18,19,20,21,22,23,24,25,26,27,28,29,30,31,32,33,34,35,36,37,38,39,40,41,42,43,44,45,46,47,48,49,50,51,52,53,54,55,56,57,58,59,60,61,62,63,64,65,66,67,68,
0,1,2,3,4,5,6,7,8,9,10,11,12,13,14,15,16,17,18,19,20,21,22,23,22,21,20,19,18,17,16,15,14,13,12,11,10,9,8,7,6,5,4,3,2,2,3,4,5,6,7,8,9,10,11,12,13,14,15,16,17,18,19,20,21,22,23,24,25,26,27,28,29,30,31,32,33,34,35,36,37,38,39,40,41,42,43,44,45,46,47,48,49,50,51,52,53,54,55,56,57,58,59,60,61,62,63,64,65,66,67,
0,1,2,3,4,5,6,7,8,9,10,11,12,13,14,15,16,17,18,19,20,21,22,22,21,20,19,18,17,16,15,14,13,12,11,10,9,8,7,6,5,4,3,2,1,1,2,3,4,5,6,7,8,9,10,11,12,13,14,15,16,17,18,19,20,21,22,23,24,25,26,27,28,29,30,31,32,33,34,35,36,37,38,39,40,41,42,43,44,45,46,47,48,49,50,51,52,53,54,55,56,57,58,59,60,61,62,63,64,65,66,
1,2,3,4,5,6,7,8,9,10,11,12,13,14,15,16,17,18,19,20,21,22,22,21,20,19,18,17,16,15,14,13,12,11,10,9,8,7,6,5,4,3,2,1,0,0,1,2,3,4,5,6,7,8,9,10,11,12,13,14,15,16,17,18,19,20,21,22,23,24,25,26,27,28,29,30,31,32,33,34,35,36,37,38,39,40,41,42,43,44,45,46,47,48,49,50,51,52,53,54,55,56,57,58,59,60,61,62,63,64,65,
